Country,Year,tot_revenue,tot_cost,resource_rent,nat_contrib
Albania,1995,231595561,90348846,141246715,0.6098852430077448
Albania,1996,315425782,89663890,225761892,0.7157369653441963
Albania,1997,258822551,88990349,169832202,0.6561723518442564
Albania,1998,302156149,88328034,213828115,0.7076742131764461
Albania,1999,356324556,87676758,268647798,0.7539412972705704
Albania,2000,296968318,87036336,209931982,0.7069170994866867
Albania,2001,237316856,86406588,150910268,0.6359020195345921
Albania,2002,258667814,85787336,172880478,0.6683493988935167
Albania,2003,427885964,85178404,342707560,0.8009319978535215
Albania,2004,564213543,84579622,479633921,0.8500928893867405
Albania,2005,584280778,83990819,500289959,0.8562492175636831
Albania,2006,615478025,83411829,532066196,0.8644763490946732
Albania,2007,358267532,83086709,275180823,0.7680875279538308
Albania,2008,535102034,91842827,443259207,0.828363898538274
Albania,2009,664027431,91174550,572852881,0.8626946030487105
Albania,2010,922883948,95009334,827874614,0.8970516995057758
Albania,2011,532422382,99036112,433386270,0.8139895779212377
Albania,2012,566034770,123261183,442773587,0.7822374356967505
Albania,2013,853316088,150611897,702704191,0.8234981162103673
Albania,2014,580476655,149236254,431240401,0.7429073973698391
Albania,2015,426815565,161861780,264953785,0.6207687974078452
Albania,2016,547953005,168898433,379054572,0.6917647472341173
Albania,2017,346543115,195659110,150884005,0.435397497364794
Albania,2018,722254003,202515370,519738633,0.7196064415582062
Albania,2019,430371901,214121318,216250583,0.5024737500230063
Albania,2020,443274809,232576167,210698642,0.47532284199799857
Angola,1995,112570209,25147778,87422431,0.7766036127728962
Angola,1996,114498978,24875741,89623237,0.782742680899737
Angola,1997,101447081,24608239,76838842,0.7574278258435055
Angola,1998,124342598,24345194,99997404,0.8042087394699603
Angola,1999,100878665,24086534,76792131,0.761232625352447
Angola,2000,91791354,23832185,67959169,0.7403656884721409
Angola,2001,102048169,23582075,78466094,0.7689123163003542
Angola,2002,118482759,23336133,95146626,0.803041951445442
Angola,2003,150564611,23094291,127470320,0.8466154108417947
Angola,2004,230355130,57749286,172605844,0.7493032345318292
Angola,2005,303875364,57033585,246841779,0.8123125736510841
Angola,2006,380058308,56329812,323728496,0.8517863948391835
Angola,2007,443864559,82559937,361304622,0.813997456372722
Angola,2008,600114502,84164370,515950132,0.8597528143054274
Angola,2009,591127098,83092928,508034170,0.8594330588444788
Angola,2010,670177324,107598867,562578457,0.8394471684631335
Angola,2011,780941086,106209877,674731209,0.8639975807342783
Angola,2012,703939588,119541410,584398178,0.8301822883130704
Angola,2013,807249127,131974219,675274908,0.8365136429562221
Angola,2014,965711033,184085147,781625886,0.8093786436009373
Angola,2015,825823284,195566209,630257075,0.763186370753867
Angola,2016,926443687,313603822,612839865,0.6614971569232573
Angola,2017,1268946849,510061856,758884993,0.5980431675274998
Angola,2018,1700096353,650109243,1049987110,0.6176044717390203
Angola,2019,1811394049,690026207,1121367842,0.619063445979114
Angola,2020,2010641477,882384088,1128257389,0.5611429993394094
Argentina,1995,2067145053,809007930,1258137123,0.6086351420642178
Argentina,1996,1763561454,884139171,879422283,0.498662681136146
Argentina,1997,2174015207,938557066,1235458141,0.568284038226601
Argentina,1998,2070401505,953912877,1116488628,0.5392618896883965
Argentina,1999,1667423060,984382604,683040456,0.40963836496299866
Argentina,2000,2220153273,972205286,1247947987,0.5620999244406673
Argentina,2001,2829826849,966774119,1863052730,0.6583628007693696
Argentina,2002,1125065047,981888587,143176460,0.12726060629274888
Argentina,2003,1271203731,976316323,294887408,0.23197493903516556
Argentina,2004,1175362432,980786868,194575564,0.1655451618177975
Argentina,2005,1456108612,971713148,484395464,0.33266437682465955
Argentina,2006,1715278299,959916337,755361962,0.4403728318841163
Argentina,2007,1490957206,973783593,517173613,0.346873546013768
Argentina,2008,1593562191,970046622,623515569,0.3912715628680475
Argentina,2009,1615469662,1000070289,615399373,0.380941460849297
Argentina,2010,1614748753,992177877,622570876,0.3855527832694354
Argentina,2011,1533264868,1039151625,494113243,0.32226215659954716
Argentina,2012,1364491740,1027745162,336746578,0.24679268340605712
Argentina,2013,1322137321,1019741487,302395834,0.22871741777267326
Argentina,2014,1477935104,1012815027,465120077,0.3147094048589565
Argentina,2015,1191122259,1006850820,184271439,0.15470405124886513
Argentina,2016,1269460319,1009663078,259797241,0.20465172255612663
Argentina,2017,1917095173,1138031045,779064128,0.4063773875038597
Argentina,2018,2091324769,1139383522,951941247,0.4551857564691809
Argentina,2019,1793325360,1133079586,660245774,0.36816842538824074
Argentina,2020,981537422,1119543310,-138005888,-0.14060175894139265
Armenia,1995,40310429,54700226,-14389797,-0.35697454373407933
Armenia,1996,34630157,54181615,-19551458,-0.5645789593157201
Armenia,1997,27595461,53671647,-26076186,-0.9449447501529328
Armenia,1998,31711997,53170178,-21458181,-0.676658142973462
Armenia,1999,24977241,52677068,-27699827,-1.1090026716721835
Armenia,2000,27828286,52192176,-24363890,-0.8755081071108727
Armenia,2001,22193174,62547447,-40354273,-1.8183191372266085
Armenia,2002,39342457,73912013,-34569556,-0.878683199679166
Armenia,2003,49814521,74212317,-24397796,-0.48977277127687324
Armenia,2004,58706356,73436759,-14730403,-0.25091666394691575
Armenia,2005,64400664,73496070,-9095406,-0.14123155624606604
Armenia,2006,77913949,76859375,1054574,0.013535111665306555
Armenia,2007,102991764,83800823,19190941,0.18633471507488697
Armenia,2008,119297145,86316029,32981116,0.2764619052702393
Armenia,2009,120725945,90815212,29910733,0.24775729028254861
Armenia,2010,158800020,104278483,54521537,0.3433345726278876
Armenia,2011,154523905,112042707,42481198,0.27491667389586094
Armenia,2012,132564357,123347704,9216653,0.06952587564695085
Armenia,2013,138405463,135586731,2818732,0.02036575680542321
Armenia,2014,146877189,135579405,11297784,0.07691993615155585
Armenia,2015,160688003,133988976,26699027,0.16615445149318334
Armenia,2016,182747308,140217940,42529368,0.23272226806208277
Armenia,2017,162303606,143254168,19049438,0.1173691606087914
Armenia,2018,164093834,144640088,19453746,0.11855257157316465
Armenia,2019,165645222,143525385,22119837,0.13353742856525014
Armenia,2020,194391740,143498744,50892996,0.2618063709908662
Australia,1995,318410534,651723668,-333313134,-1.0468030997994557
Australia,1996,322287216,646974515,-324687299,-1.0074470313461021
Australia,1997,332995659,642304514,-309308855,-0.9288675291710033
Australia,1998,266069955,637712347,-371642392,-1.3967845110508625
Australia,1999,286092732,633196715,-347103983,-1.2132569065054053
Australia,2000,258703676,628756345,-370052669,-1.4304113289832032
Australia,2001,260424191,624389980,-363965789,-1.3975882486277935
Australia,2002,264392026,620096388,-355704362,-1.3453672086161932
Australia,2003,334838774,615874356,-281035582,-0.8393161241236655
Australia,2004,396307048,628840193,-232533145,-0.586749961105915
Australia,2005,446265853,769100415,-322834562,-0.7234130951982114
Australia,2006,514412292,763097900,-248685608,-0.4834363639195465
Australia,2007,571312993,757195427,-185882434,-0.32536006755932473
Australia,2008,522813802,751391329,-228577527,-0.4372063746702693
Australia,2009,525207160,745683966,-220476806,-0.41979017574703287
Australia,2010,765182019,740071725,25110294,0.032816105680078714
Australia,2011,1145173088,734553022,410620066,0.35856594108156337
Australia,2012,1030910346,729126297,301784049,0.29273549360615303
Australia,2013,1303815031,723790017,580025014,0.4448675618926808
Australia,2014,1298736693,718542676,580194017,0.4467372178880912
Australia,2015,706894871,713382790,-6487919,-0.00917805357792729
Australia,2016,758774827,708308902,50465925,0.06650975125193498
Australia,2017,950598890,703319580,247279310,0.26013002182234823
Australia,2018,981955105,775734837,206220268,0.21000987412759567
Australia,2019,905231839,769957928,135273911,0.14943565302501474
Australia,2020,768653958,764277302,4376656,0.005693922413914116
Austria,1995,1631056386,652032427,979023959,0.6002391869486233
Austria,1996,1567060510,654089196,912971314,0.5826011874933917
Austria,1997,1471528477,667259242,804269235,0.546553632886304
Austria,1998,1508064926,679286863,828778063,0.5495639138019446
Austria,1999,1307861712,673682389,634179323,0.4848978429303541
Austria,2000,1231640645,669610791,562029854,0.4563261664687917
Austria,2001,1199270735,669854042,529416693,0.44144885516613563
Austria,2002,1311384456,664437736,646946720,0.49333108764558975
Austria,2003,1266196577,668042055,598154522,0.47240257386985496
Austria,2004,1626220244,670074593,956145651,0.5879558162725712
Austria,2005,1617560167,695762946,921797221,0.5698688925492068
Austria,2006,1555744194,696303103,859441091,0.5524308522664492
Austria,2007,1980546902,714921476,1265625426,0.6390282526114093
Austria,2008,2477699637,777734410,1699965227,0.6861062582461847
Austria,2009,2624510388,800136726,1824373662,0.6951291449794025
Austria,2010,2473102299,839758569,1633343730,0.6604432540701787
Austria,2011,2336468665,883117074,1453351591,0.6220291385760999
Austria,2012,2782273911,899480955,1882792956,0.6767101357476661
Austria,2013,2857353689,905305301,1952048388,0.683166524156541
Austria,2014,2739955580,925572755,1814382825,0.6621942480541966
Austria,2015,2058067428,939961916,1118105512,0.5432793390479721
Austria,2016,2229262080,999780709,1229481371,0.5515194386655516
Austria,2017,2128954781,999096220,1129858561,0.5307104552353571
Austria,2018,2167955696,1045865219,1122090477,0.5175799851769665
Austria,2019,2260438885,1048889481,1211549404,0.5359797214778492
Austria,2020,2490969808,1041230503,1449739305,0.5819979432685279
Azerbaijan,1995,32270847,29619728,2651119,0.08215213564118723
Azerbaijan,1996,39209048,29277213,9931835,0.2533046709014715
Azerbaijan,1997,48835085,28940406,19894679,0.40738495694232946
Azerbaijan,1998,56883628,28609213,28274415,0.4970571673100738
Azerbaijan,1999,37717281,28283539,9433742,0.25011723406042974
Azerbaijan,2000,36017516,47009176,-10991660,-0.30517540410060484
Azerbaijan,2001,29804178,48920311,-19116133,-0.6413910492683275
Azerbaijan,2002,45559639,48521759,-2962120,-0.06501631850067996
Azerbaijan,2003,56351870,56415732,-63862,-0.0011332720635535253
Azerbaijan,2004,67060485,55673975,11386510,0.1697946264480491
Azerbaijan,2005,83500003,54944580,28555423,0.3419811014857089
Azerbaijan,2006,80098040,62941584,17156456,0.21419320622577032
Azerbaijan,2007,91371475,62104678,29266797,0.3203056205451428
Azerbaijan,2008,108890545,61281721,47608824,0.4372172441601794
Azerbaijan,2009,116778788,60472479,56306309,0.48216212862219465
Azerbaijan,2010,184596252,62044491,122551761,0.663890841077315
Azerbaijan,2011,157138944,62132551,95006393,0.6046011929417064
Azerbaijan,2012,108632056,69008670,39623386,0.3647485600383003
Azerbaijan,2013,91152397,76966172,14186225,0.15563194679345624
Azerbaijan,2014,79556574,75926534,3630040,0.04562841029328387
Azerbaijan,2015,76716275,83037894,-6321619,-0.0824025801565574
Azerbaijan,2016,68759363,82413693,-13654330,-0.19858139174442324
Azerbaijan,2017,64938725,81696264,-16757539,-0.2580515555240729
Azerbaijan,2018,66559347,87722802,-21163455,-0.31796368134440983
Azerbaijan,2019,58910117,90693282,-31783165,-0.5395196380275394
Azerbaijan,2020,40263529,91295412,-51031883,-1.2674468499768115
Bangladesh,1995,21250136,13673812,7576324,0.3565306123217282
Bangladesh,1996,40183242,13524477,26658765,0.6634299193678798
Bangladesh,1997,39023144,13377631,25645513,0.657187257900081
Bangladesh,1998,43531873,13233232,30298641,0.696010507059965
Bangladesh,1999,41060854,13091239,27969615,0.6811747023089193
Bangladesh,2000,56487053,12951614,43535439,0.7707153531270254
Bangladesh,2001,52722855,12814315,39908540,0.7569495240726247
Bangladesh,2002,55214201,12679305,42534896,0.770361523478353
Bangladesh,2003,58439339,12546544,45892795,0.7853065381180988
Bangladesh,2004,62952552,12415997,50536555,0.8027721417870398
Bangladesh,2005,64340693,12287625,52053068,0.8090224952970276
Bangladesh,2006,67444311,12161393,55282918,0.8196824488280413
Bangladesh,2007,47704208,12037265,35666943,0.7476686962290622
Bangladesh,2008,52875444,11915205,40960239,0.7746552255901624
Bangladesh,2009,30307505,11795180,18512325,0.6108165287772781
Bangladesh,2010,52163633,11677155,40486478,0.776143755171347
Bangladesh,2011,60682438,11561097,49121341,0.809481995433341
Bangladesh,2012,55074013,11446974,43627039,0.7921528979557019
Bangladesh,2013,57203155,12459022,44744133,0.7821969435077488
Bangladesh,2014,41549597,12332675,29216922,0.703181838322042
Bangladesh,2015,45986937,12208434,33778503,0.7345238714202688
Bangladesh,2016,66779492,12086264,54693228,0.8190123398962065
Bangladesh,2017,73404272,11966130,61438142,0.8369831935667178
Bangladesh,2018,64081325,11847998,52233327,0.8151099715868859
Bangladesh,2019,48506064,11731835,36774229,0.7581367352337638
Bangladesh,2020,51329036,11617608,39711428,0.7736640134835183
Belgium,1995,12557036,5739750,6817286,0.5429056665920206
Belgium,1996,11793495,5691549,6101946,0.5173992951198945
Belgium,1997,11372848,5644152,5728696,0.5037169229730319
Belgium,1998,13298089,5795810,7502279,0.5641621890182867
Belgium,1999,12215306,6953787,5261519,0.4307316574795588
Belgium,2000,15241708,6891458,8350250,0.5478552666144766
Belgium,2001,14737300,8513191,6224109,0.4223371309534311
Belgium,2002,13191758,8432190,4759568,0.3607986138011325
Belgium,2003,11229430,8352539,2876891,0.25619207742512307
Belgium,2004,16409716,9392370,7017346,0.4276336043841344
Belgium,2005,15431007,9301578,6129429,0.3972151007384029
Belgium,2006,20070873,9687870,10383003,0.5173169597555622
Belgium,2007,24501776,10326878,14174898,0.5785253281231532
Belgium,2008,28559036,10474581,18084455,0.6332305824328244
Belgium,2009,20404250,10372086,10032164,0.49167031378266784
Belgium,2010,19219813,12517262,6702551,0.34873133260973976
Belgium,2011,13891923,12677052,1214871,0.08745160767159449
Belgium,2012,24268420,12840805,11427615,0.4708841778739613
Belgium,2013,26641951,12711154,13930797,0.5228895211165279
Belgium,2014,19149536,13188935,5960601,0.31126607976297704
Belgium,2015,19072716,13056113,6016603,0.3154560158081314
Belgium,2016,27049367,12925505,14123862,0.522151294704974
Belgium,2017,21643010,12797074,8845936,0.408720228840628
Belgium,2018,24033262,12878430,11154832,0.4641414053572919
Belgium,2019,23875845,12751687,11124158,0.4659168293310666
Belgium,2020,20969325,13082179,7887146,0.37612779619754094
Belize,2000,4719544,6929666,-2210122,-0.4682914281549234
Belize,2001,5379458,6833971,-1454513,-0.2703828155178459
Belize,2002,4598802,6739870,-2141068,-0.4655708160516587
Belize,2003,3442844,6647338,-3204494,-0.9307694452609528
Belize,2004,3605865,6556348,-2950483,-0.8182455527314528
Belize,2005,4892346,7557829,-2665483,-0.5448271647181128
Belize,2006,14063844,10228499,3835345,0.2727095806807868
Belize,2007,14507799,11117587,3390212,0.23368203543487195
Belize,2008,17490689,10966074,6524615,0.37303361805815655
Belize,2009,14968749,10817086,4151663,0.27735537552269734
Belize,2010,22367179,11716652,10650527,0.4761676472477821
Belize,2011,25175561,11558143,13617418,0.5408982941829975
Belize,2012,20739565,11402276,9337289,0.4502162412760345
Belize,2013,20888531,11486231,9402300,0.4501178182419817
Belize,2014,20608835,11332240,9276595,0.4501270935499265
Belize,2015,18173284,11180816,6992468,0.38476634162543216
Belize,2016,21434369,11031916,10402453,0.48531650266914783
Belize,2017,24009473,10885497,13123976,0.5466165792143792
Belize,2018,21814660,14686991,7127669,0.3267375700560999
Belize,2019,22925831,15118352,7807479,0.34055380587949025
Belize,2020,20633967,14916892,5717075,0.27707105473222865
Bolivia,1995,55890051,24471246,31418805,0.5621538080185327
Bolivia,1996,66528240,46565331,19962909,0.30006669348234677
Bolivia,1997,71267602,45988641,25278961,0.35470480682091704
Bolivia,1998,69883178,54321201,15561977,0.22268559394937648
Bolivia,1999,87426563,62502543,24924020,0.2850852091714963
Bolivia,2000,93609296,61710980,31898316,0.34076013134422034
Bolivia,2001,104262763,62436628,41826135,0.40116081519919056
Bolivia,2002,104712932,77488663,27224269,0.25998955888275577
Bolivia,2003,94852856,76496881,18355975,0.19352053036758324
Bolivia,2004,104813344,79933414,24879930,0.2373736878388309
Bolivia,2005,99417423,78913491,20503932,0.20624083164980045
Bolivia,2006,113532623,84136128,29396495,0.25892553367678295
Bolivia,2007,129200118,83356782,45843336,0.3548242579778449
Bolivia,2008,128210998,84431886,43779112,0.3414614399928468
Bolivia,2009,127328776,83361708,43967068,0.34530346855764954
Bolivia,2010,121068491,82333765,38734726,0.31994060287742415
Bolivia,2011,130595963,82873487,47722476,0.36542075959882464
Bolivia,2012,130812982,81835344,48977638,0.3744096132599439
Bolivia,2013,141319424,84710501,56608923,0.40057425510027556
Bolivia,2014,125567539,83891197,41676342,0.3319037892428552
Bolivia,2015,128355674,83071363,45284311,0.35280334393320234
Bolivia,2016,84276660,82056639,2220021,0.026342061965910848
Bolivia,2017,109409302,111713452,-2304150,-0.021059909512995523
Bolivia,2018,129008971,125082760,3926211,0.03043362775136002
Bolivia,2019,172689468,141338571,31350897,0.1815449278006925
Bolivia,2020,161113429,139517934,21595495,0.13403907504196935
Bosnia and Herzegovina,1995,174233600,36216969,138016631,0.7921355639784748
Bosnia and Herzegovina,1996,249301276,43203211,206098065,0.8267028083723086
Bosnia and Herzegovina,1997,223077605,42962213,180115392,0.8074113580339004
Bosnia and Herzegovina,1998,217563788,42725232,174838556,0.8036197457639412
Bosnia and Herzegovina,1999,255938114,80200219,175737895,0.6866421427173601
Bosnia and Herzegovina,2000,207297572,113695969,93601603,0.45153255822986677
Bosnia and Herzegovina,2001,207026744,112592689,94434055,0.45614423129796217
Bosnia and Herzegovina,2002,223819973,111507797,112312176,0.5017969330199141
Bosnia and Herzegovina,2003,231846490,110440986,121405504,0.523646072882104
Bosnia and Herzegovina,2004,342544212,116100881,226443331,0.6610630776035415
Bosnia and Herzegovina,2005,347940739,114986688,232954051,0.6695222056190436
Bosnia and Herzegovina,2006,345194875,113891065,231303810,0.6700673351538026
Bosnia and Herzegovina,2007,260291187,112813703,147477484,0.5665865437080665
Bosnia and Herzegovina,2008,343624222,119368077,224256145,0.6526203062600168
Bosnia and Herzegovina,2009,422330136,118232535,304097601,0.7200471268287613
Bosnia and Herzegovina,2010,523649012,139927699,383721313,0.7327834182946955
Bosnia and Herzegovina,2011,303722529,139035836,164686693,0.5422274519517122
Bosnia and Herzegovina,2012,268405628,137951145,130454483,0.4860348271087669
Bosnia and Herzegovina,2013,487679827,136863903,350815924,0.7193570547259893
Bosnia and Herzegovina,2014,393331822,138354887,254976935,0.6482489357293852
Bosnia and Herzegovina,2015,322768120,138812357,183955763,0.5699316369906668
Bosnia and Herzegovina,2016,327309583,148242543,179067040,0.5470876787619139
Bosnia and Herzegovina,2017,231778512,154592018,77186494,0.3330183343311825
Bosnia and Herzegovina,2018,411701945,159458884,252243061,0.6126836758082355
Bosnia and Herzegovina,2019,370796128,158743176,212052952,0.5718855618686504
Bosnia and Herzegovina,2020,286639610,159851034,126788576,0.44232747874587186
Brazil,1995,28274725540,2451740861,25822984679,0.9132886061959631
Brazil,1996,28468010199,2697289304,25770720895,0.9052519201326285
Brazil,1997,29353320591,2851920350,26501400241,0.9028416447413985
Brazil,1998,30012555527,3063527911,26949027616,0.8979251230957664
Brazil,1999,20335664344,3323595406,17012068938,0.8365632246000058
Brazil,2000,22069722669,3552850451,18516872218,0.8390169870149536
Brazil,2001,15931104429,3711589975,12219514454,0.7670224313988143
Brazil,2002,14422178328,4041478432,10380699896,0.7197733698692621
Brazil,2003,15402575090,4399332521,11003242569,0.714376817168953
Brazil,2004,19355604297,4501693079,14853911218,0.7674217239656147
Brazil,2005,26946480596,4737076048,22209404548,0.8242042766541029
Brazil,2006,33249375186,5083165668,28166209518,0.8471199642229572
Brazil,2007,39479785423,5548925402,33930860021,0.8594489472891784
Brazil,2008,39321228416,5605037609,33716190807,0.8574551753647838
Brazil,2009,39506951923,5700519811,33806432112,0.8557084377931649
Brazil,2010,47734004861,6001409241,41732595620,0.8742739215266784
Brazil,2011,56051300119,6256526936,49794773183,0.8883785581651621
Brazil,2012,49177923276,6523333934,42654589342,0.8673523910843234
Brazil,2013,35572272907,6771647906,28800625001,0.8096369067081047
Brazil,2014,33274525393,7301612220,25972913173,0.7805644969008019
Brazil,2015,32432939006,7691042604,24741896402,0.7628632236327032
Brazil,2016,34880064435,8468709441,26411354994,0.7572048796876025
Brazil,2017,37165708151,8936021698,28229686453,0.7595627221283132
Brazil,2018,38209129300,9517441157,28691688143,0.7509118545394333
Brazil,2019,38870081623,10242553201,28627528422,0.7364926243185625
Brazil,2020,28940215596,10143859991,18796355605,0.6494891353745809
Bulgaria,1995,46701087,87617554,-40916467,-0.8761352171524401
Bulgaria,1996,49296346,86845058,-37548712,-0.7616936151819447
Bulgaria,1997,60748955,86085437,-25336482,-0.4170686063653276
Bulgaria,1998,78074426,85536742,-7462316,-0.09557951793331147
Bulgaria,1999,68832775,84799788,-15967013,-0.23196817213892654
Bulgaria,2000,67135537,144061700,-76926163,-1.1458337333326163
Bulgaria,2001,43962943,142610142,-98647199,-2.2438715943106904
Bulgaria,2002,62692175,172653375,-109961200,-1.7539860437127919
Bulgaria,2003,108863943,246073233,-137209290,-1.2603740615935617
Bulgaria,2004,133225349,243385315,-110159966,-0.826869412066618
Bulgaria,2005,191708579,240742197,-49033618,-0.2557716418105629
Bulgaria,2006,203523910,238143130,-34619220,-0.17009903160763765
Bulgaria,2007,152619693,242425525,-89805832,-0.5884288602257901
Bulgaria,2008,172560445,256193167,-83632722,-0.48465754709893105
Bulgaria,2009,216453485,257695217,-41241732,-0.1905339246443641
Bulgaria,2010,303839734,268128020,35711714,0.11753470663583454
Bulgaria,2011,187077737,276024186,-88946449,-0.47545181177811663
Bulgaria,2012,202761511,286416302,-83654791,-0.41257727163021585
Bulgaria,2013,270028156,289874071,-19845915,-0.07349572464584027
Bulgaria,2014,290015194,291608402,-1593208,-0.005493532866419406
Bulgaria,2015,329655565,288492717,41162848,0.12486623121317549
Bulgaria,2016,224097302,286423524,-62326222,-0.2781212510983287
Bulgaria,2017,171045382,305567271,-134521889,-0.7864689910190034
Bulgaria,2018,334178739,304136552,30042187,0.08989855874703029
Bulgaria,2019,175491713,300920675,-125428962,-0.7147286892116667
Bulgaria,2020,170749046,297758395,-127009349,-0.743836360877823
Burkina Faso,1995,6938795,2096547,4842248,0.6978514280937829
Burkina Faso,1996,5644301,2075530,3568771,0.6322786470813658
Burkina Faso,1997,4722794,2054864,2667930,0.5649050117366965
Burkina Faso,1998,6320928,2034542,4286386,0.678126059970941
Burkina Faso,1999,7976279,2014558,5961721,0.7474313523887517
Burkina Faso,2000,5847490,1994908,3852582,0.6588437090101907
Burkina Faso,2001,3391890,1975585,1416305,0.4175562886768144
Burkina Faso,2002,4085752,1956584,2129168,0.5211202246244999
Burkina Faso,2003,6366777,2228612,4138165,0.6499622964649147
Burkina Faso,2004,7327461,2206225,5121236,0.6989100317285892
Burkina Faso,2005,7787698,2184211,5603487,0.7195305981305387
Burkina Faso,2006,6685074,2162563,4522511,0.6765087417132555
Burkina Faso,2007,9720174,2141277,7578897,0.7797079558452349
Burkina Faso,2008,13464022,2120345,11343677,0.8425177112752786
Burkina Faso,2009,13121091,2099762,11021329,0.8399704719676131
Burkina Faso,2010,11426088,2079522,9346566,0.8180022768947692
Burkina Faso,2011,8432078,2059620,6372458,0.7557399255557171
Burkina Faso,2012,10443426,2040049,8403377,0.8046571115647299
Burkina Faso,2013,11912056,2020805,9891251,0.8303563213604771
Burkina Faso,2014,10152522,2001881,8150641,0.8028193388795415
Burkina Faso,2015,9606030,1983272,7622758,0.7935388500764624
Burkina Faso,2016,14300200,1964974,12335226,0.8625911525712927
Burkina Faso,2017,13240934,1946981,11293953,0.8529574273234803
Burkina Faso,2018,9888756,1929287,7959469,0.8049009400171265
Burkina Faso,2019,11766298,1992794,9773504,0.8306354301072436
Burkina Faso,2020,12490555,1974568,10515987,0.8419151110579154
Burundi,1995,8710403,3637177,5073226,0.5824329827219246
Burundi,1996,9024764,3594785,5429979,0.601675456554875
Burundi,1997,9215209,3553098,5662111,0.6144310997178686
Burundi,1998,8879976,3512107,5367869,0.604491386012755
Burundi,1999,6268447,3471799,2796648,0.4461468685944062
Burundi,2000,5817147,3432162,2384985,0.4099922178346189
Burundi,2001,7090243,3393186,3697057,0.5214288142169458
Burundi,2002,7973239,3354860,4618379,0.5792349884407078
Burundi,2003,6617743,3317173,3300570,0.4987455692975687
Burundi,2004,6498898,3280113,3218785,0.49528166159862796
Burundi,2005,7601308,3243672,4357636,0.5732744943370273
Burundi,2006,10150900,3207837,6943063,0.68398496685023
Burundi,2007,13575074,3172600,10402474,0.7662922500459297
Burundi,2008,15848892,3137950,12710942,0.8020082413332111
Burundi,2009,15511152,3103878,12407274,0.7998937796496353
Burundi,2010,16938115,3070374,13867741,0.8187298881841338
Burundi,2011,18564775,3037428,15527347,0.8363875673149823
Burundi,2012,20639182,3005031,17634151,0.8544016424681947
Burundi,2013,21429058,2973174,18455884,0.8612550304357756
Burundi,2014,20950971,2941848,18009123,0.8595841691537829
Burundi,2015,18806691,6280472,12526219,0.6660511942265654
Burundi,2016,20844698,6203651,14641047,0.7023871010268414
Burundi,2017,18133502,6128111,12005391,0.6620558455834952
Burundi,2018,19760747,6053830,13706917,0.6936436664059309
Burundi,2019,20355808,5980786,14375022,0.7061877376717249
Burundi,2020,24367816,5908960,18458856,0.7575096594623006
Cambodia,2000,1850312,1949497,-99185,-0.053604473191548235
Cambodia,2001,1257296,2121203,-863907,-0.6871150468942874
Cambodia,2002,1351477,2293530,-942053,-0.6970544078811552
Cambodia,2003,2058776,2261039,-202263,-0.09824429661119034
Cambodia,2004,1504794,2441097,-936303,-0.6222134059545692
Cambodia,2005,2425657,2406664,18993,0.007830043571700368
Cambodia,2006,3067073,2372805,694268,0.2263617461990634
Cambodia,2007,3279906,2339511,940395,0.28671400948685727
Cambodia,2008,3323140,2407729,915411,0.2754656740311874
Cambodia,2009,3429610,2374099,1055511,0.30776414811013497
Cambodia,2010,2621216,2341029,280187,0.10689199211358393
Cambodia,2011,4551553,37955396,-33403843,-7.338999018576736
Cambodia,2012,48385941,41471699,6914242,0.14289774792227353
Cambodia,2013,94176391,128251517,-34075126,-0.36182238072809564
Cambodia,2014,166671086,174230044,-7558958,-0.045352545431905325
Cambodia,2015,174633804,171825125,2808679,0.016083249265989762
Cambodia,2016,203595042,169482961,34112081,0.16754868225130945
Cambodia,2017,213872186,182022139,31850047,0.14892094009830711
Cambodia,2018,387989579,260846319,127143260,0.3276976158166351
Cambodia,2019,326522759,257167189,69355570,0.2124065416218047
Cambodia,2020,289187066,253549379,35637687,0.12323402803913783
Cameroon,1995,344339763,38590674,305749089,0.8879284992712271
Cameroon,1996,355008723,38184922,316823801,0.8924394823954791
Cameroon,1997,358484999,70952555,287532444,0.8020766414273307
Cameroon,1998,365520319,70102199,295418120,0.8082125798319847
Cameroon,1999,376207462,69266016,306941446,0.8158834605997263
Cameroon,2000,351130914,68443769,282687145,0.8050762086986166
Cameroon,2001,352222372,78445538,273776834,0.7772840562211647
Cameroon,2002,334036654,78213699,255822955,0.7658529443897495
Cameroon,2003,432868120,77275247,355592873,0.8214808542611084
Cameroon,2004,520629091,76352435,444276656,0.853345815053581
Cameroon,2005,520453368,75445004,445008364,0.8550398390351083
Cameroon,2006,570190015,74552696,495637319,0.8692493834708768
Cameroon,2007,636587374,73675261,562912113,0.8842652807625431
Cameroon,2008,810451842,72812449,737639393,0.9101582040700699
Cameroon,2009,744173772,71964017,672209755,0.9032967571450503
Cameroon,2010,778167204,72450622,705716582,0.9068958166990548
Cameroon,2011,857592435,73364747,784227688,0.9144526653852771
Cameroon,2012,792394582,72515892,719878690,0.9084851238924802
Cameroon,2013,844860615,73079070,771781545,0.9135016253539052
Cameroon,2014,842911003,72238970,770672033,0.914298223960899
Cameroon,2015,708903503,71412873,637490630,0.899262914207944
Cameroon,2016,702118122,70600543,631517579,0.8994463455822893
Cameroon,2017,787523693,78495158,709028535,0.9003266076973763
Cameroon,2018,817883282,77589629,740293653,0.9051336166081458
Cameroon,2019,800823638,100059672,700763966,0.8750540477927301
Cameroon,2020,824613233,98861478,725751755,0.8801117008026477
Canada,1995,11499266364,5219796241,6279470123,0.5460757168525747
Canada,1996,12332158299,5318239286,7013919013,0.5687503227694337
Canada,1997,12142665434,5459290094,6683375340,0.5504043059019195
Canada,1998,10859730373,5433628849,5426101524,0.4996534294710155
Canada,1999,11310729996,5414368525,5896361471,0.5213068893948691
Canada,2000,11382356033,5416319434,5966036599,0.5241477758825258
Canada,2001,10497728165,5370425585,5127302580,0.4884202085832921
Canada,2002,11331360676,5699638599,5631722077,0.4970031612291784
Canada,2003,12399349193,5858375273,6540973920,0.527525583656655
Canada,2004,13813795545,5895838704,7917956841,0.5731919815380473
Canada,2005,16437802547,6055946414,10381856133,0.6315841854965433
Canada,2006,17469264738,6170196365,11299068373,0.6467970199353447
Canada,2007,19487284839,6239928362,13247356477,0.6797948809414434
Canada,2008,20459165626,6378202727,14080962899,0.6882471727539843
Canada,2009,18349627800,6379471019,11970156781,0.6523378518337032
Canada,2010,19666625125,6394676211,13271948914,0.6748462855037005
Canada,2011,23651787832,6430675242,17221112590,0.7281103953883972
Canada,2012,23832684425,6374765382,17457919043,0.7325200439731833
Canada,2013,24391742193,6319787354,18071954839,0.7409046346917496
Canada,2014,22641452932,6265725625,16375727307,0.7232630942979626
Canada,2015,21247664717,6989117920,14258546797,0.6710641845544517
Canada,2016,24581669234,7156950206,17424719028,0.7088501135593793
Canada,2017,25802525931,7230545066,18571980865,0.7197737506267561
Canada,2018,26168100625,7340159621,18827941004,0.7194997173777491
Canada,2019,25696990550,7274819273,18422171277,0.7168999514225217
Canada,2020,25285162629,7211214369,18073948260,0.7148045090788013
Central African Republic,1995,5979175,2279279,3699896,0.6187970748472824
Central African Republic,1996,6271446,2250421,4021025,0.6411639357175363
Central African Republic,1997,6297059,2222044,4075015,0.64712987443821
Central African Republic,1998,6619619,2194141,4425478,0.6685396848368463
Central African Republic,1999,5372954,2166702,3206252,0.5967391494511213
Central African Republic,2000,4997600,2139720,2857880,0.5718504882343525
Central African Republic,2001,5233815,2113189,3120626,0.5962430846332933
Central African Republic,2002,5316987,2087099,3229888,0.6074658448478434
Central African Republic,2003,5577029,2061445,3515584,0.6303686066541881
Central African Republic,2004,9025745,2036217,6989528,0.774399010829577
Central African Republic,2005,10385147,2011411,8373736,0.8063184854292386
Central African Republic,2006,11642848,1987017,9655831,0.8293358291716941
Central African Republic,2007,11974317,1963031,10011286,0.8360632176348763
Central African Republic,2008,12977132,2437580,10539552,0.8121634271732768
Central African Republic,2009,13587222,2407507,11179715,0.8228109469323457
Central African Republic,2010,13320065,2377935,10942130,0.8214772225210613
Central African Republic,2011,14357948,2348857,12009091,0.8364071941199397
Central African Republic,2012,15617853,2320263,13297590,0.8514352132780351
Central African Republic,2013,15691583,2292145,13399438,0.8539251903393048
Central African Republic,2014,15654398,2264496,13389902,0.8553444214207406
Central African Republic,2015,14440753,2237308,12203445,0.8450698519668607
Central African Republic,2016,14162318,2210573,11951745,0.8439116393234497
Central African Republic,2017,14403909,2184284,12219625,0.8483547764707483
Central African Republic,2018,15158973,2158433,13000540,0.8576135071947156
Central African Republic,2019,15769433,2133012,13636421,0.864737559048572
Central African Republic,2020,15742180,2108016,13634164,0.8660912275174086
Chile,1995,488921403,274397966,214523437,0.4387687585032967
Chile,1996,411551669,354768454,56783215,0.13797347763884296
Chile,1997,427421793,360977284,66444509,0.15545419089101056
Chile,1998,290786182,388080973,-97294791,-0.33459220906170845
Chile,1999,453315706,383623701,69692005,0.15373834190514457
Chile,2000,876660730,400157521,476503209,0.5435434629312071
Chile,2001,950682129,395558735,555123394,0.5839211415322608
Chile,2002,982439974,397800071,584639903,0.5950896934900167
Chile,2003,1006669151,395970178,610698973,0.6066531117928338
Chile,2004,1183334873,538448327,644886546,0.5449738368354501
Chile,2005,1756490665,532513435,1223977230,0.6968310474909356
Chile,2006,2197167311,527771105,1669396206,0.759794758297312
Chile,2007,2124285278,548250512,1576034766,0.7419129541225394
Chile,2008,3071410366,558369210,2513041156,0.8182042959218169
Chile,2009,2979954564,557093658,2422860906,0.813052969085471
Chile,2010,2513260002,554777511,1958482491,0.7792598017879091
Chile,2011,2454258165,656068422,1798189743,0.7326815771233259
Chile,2012,2069966719,661848390,1408118329,0.6802613375737081
Chile,2013,1885679149,677654016,1208025133,0.6406313256635581
Chile,2014,1940589249,752921990,1187667259,0.6120137270738842
Chile,2015,2090763702,756668193,1334095509,0.6380900470597514
Chile,2016,2183331826,789038907,1394292919,0.6386078846999778
Chile,2017,2355804914,779373467,1576431447,0.6691689272026028
Chile,2018,2554594536,769869117,1784725419,0.6986335380621828
Chile,2019,2390092577,760523173,1629569404,0.68180179281817
Chile,2020,2177313027,825104672,1352208355,0.6210445343557851
China,1995,5683850660,2113716314,3570134346,0.6281189565948236
China,1996,6099211500,2504707698,3594503802,0.589339097685004
China,1997,6555758699,2480554702,4075203997,0.6216220248651956
China,1998,6912993853,2970646110,3942347743,0.570280811299891
China,1999,6679376332,3611465793,3067910539,0.45931092762389364
China,2000,7385102278,5413885422,1971216856,0.2669180170831481
China,2001,9313660604,5819055476,3494605128,0.37521284880180716
China,2002,9569163947,6192258811,3376905136,0.3528944800928699
China,2003,9530822148,7346153434,2184668714,0.2292214333742911
China,2004,12371173349,8733792658,3637380691,0.29402067115113384
China,2005,14288878025,10370539557,3918338468,0.2742229628627542
China,2006,16382029075,12276859374,4105169701,0.25058981901483407
China,2007,20001524009,14841793400,5159730609,0.25796687325817264
China,2008,27993095249,18716408085,9276687164,0.33139197653862135
China,2009,29650352622,21907074457,7743278165,0.261152987410161
China,2010,36105807956,23008261800,13097546156,0.3627545510672743
China,2011,38623308321,24974454465,13648853856,0.35338386195619964
China,2012,50915578399,26776833719,24138744680,0.4740934982774171
China,2013,56101767575,30888121408,25213646167,0.4494269477925625
China,2014,66866626176,33442543455,33424082721,0.4998619585355525
China,2015,70663901870,35086583493,35577318377,0.5034723166356055
China,2016,68967318554,36403665159,32563653395,0.4721606418481143
China,2017,65710529367,37871266566,27839262801,0.423665173134048
China,2018,69588451414,38946395354,30642056060,0.4403324896210486
China,2019,70769049797,39558074839,31210974958,0.4410257739439519
China,2020,76473812393,41572198607,34901613786,0.4563864765449395
Colombia,1995,1434530355,612367779,822162576,0.5731231640615928
Colombia,1996,1605432670,636065936,969366734,0.6038040411872271
Colombia,1997,1462361213,643917528,818443685,0.5596727249904159
Colombia,1998,1413620073,647826032,765794041,0.5417255001018934
Colombia,1999,1321153111,706737866,614415245,0.46505983287201297
Colombia,2000,1375243216,698992827,676250389,0.49173148511644793
Colombia,2001,1416850749,788637451,628213298,0.44338706701703556
Colombia,2002,1329620372,846276931,483343441,0.3635198821998795
Colombia,2003,1498787064,836674047,662113017,0.4417659005095336
Colombia,2004,1745915325,839596201,906319124,0.5191082929522942
Colombia,2005,1965733083,836700741,1129032342,0.5743568909553729
Colombia,2006,2292233454,827311533,1464921921,0.6390805955840482
Colombia,2007,2462987908,831027075,1631960833,0.6625939281712462
Colombia,2008,2685415903,869692636,1815723267,0.6761422932557944
Colombia,2009,2227471459,860005393,1367466066,0.6139095791664642
Colombia,2010,2388912211,884243374,1504668837,0.6298552245124758
Colombia,2011,3087402599,1007685029,2079717570,0.6736139856439889
Colombia,2012,2916133494,1009685839,1906447655,0.653758704436046
Colombia,2013,2647947278,1020099193,1627848085,0.6147584955805906
Colombia,2014,2497545850,1109796106,1387749744,0.5556453524166534
Colombia,2015,2388690348,1383663647,1005026701,0.42074381965895563
Colombia,2016,2671938986,1395444082,1276494904,0.47774103775886145
Colombia,2017,3455999745,1407507497,2048492248,0.5927350691977554
Colombia,2018,3434983995,1418655004,2016328991,0.5869980744990342
Colombia,2019,3522244725,1422723182,2099521543,0.5960748633103568
Colombia,2020,2947309068,1414659090,1532649978,0.5200167144465896
"Congo, Dem. Rep.",1995,454638763,358086200,96552563,0.21237204316430008
"Congo, Dem. Rep.",1996,465846101,353514630,112331471,0.24113429469274447
"Congo, Dem. Rep.",1997,385810100,349019252,36790848,0.09535999187164877
"Congo, Dem. Rep.",1998,380143732,344598798,35544934,0.09350393287557876
"Congo, Dem. Rep.",1999,337856509,340252017,-2395508,-0.00709031182228903
"Congo, Dem. Rep.",2000,356227781,335977683,20250098,0.05684592578140333
"Congo, Dem. Rep.",2001,376172581,333880493,42292088,0.11242735418826286
"Congo, Dem. Rep.",2002,390830645,340406070,50424575,0.12901898979799806
"Congo, Dem. Rep.",2003,402385360,339799617,62585743,0.15553682917291026
"Congo, Dem. Rep.",2004,503309163,335579759,167729404,0.33325322948670416
"Congo, Dem. Rep.",2005,563948006,331430232,232517774,0.4123035661553523
"Congo, Dem. Rep.",2006,612024634,328301966,283722668,0.4635804708475182
"Congo, Dem. Rep.",2007,671688003,324276455,347411548,0.5172216065321029
"Congo, Dem. Rep.",2008,727636238,320318037,407318201,0.5597827317116111
"Congo, Dem. Rep.",2009,763731303,316425592,447305711,0.5856846632355464
"Congo, Dem. Rep.",2010,745179865,312598021,432581844,0.5805066190294876
"Congo, Dem. Rep.",2011,772081952,308834243,463247709,0.5999981061595907
"Congo, Dem. Rep.",2012,818377150,305133194,513243956,0.6271484437218219
"Congo, Dem. Rep.",2013,935275962,301493830,633782132,0.6776418487701922
"Congo, Dem. Rep.",2014,984138146,297915122,686223024,0.6972832287714209
"Congo, Dem. Rep.",2015,908726816,296732195,611994621,0.673463806971005
"Congo, Dem. Rep.",2016,918860782,310406601,608454181,0.662183208729002
"Congo, Dem. Rep.",2017,975570629,370569205,605001424,0.6201513309396689
"Congo, Dem. Rep.",2018,1163081061,388299160,774781901,0.6661460898811764
"Congo, Dem. Rep.",2019,1253038305,385577688,867460617,0.6922857932902539
"Congo, Dem. Rep.",2020,1294309103,380904900,913404203,0.7057079339725543
"Congo, Rep.",1995,40650353,6171405,34478948,0.8481832371787767
"Congo, Rep.",1996,43819068,6104617,37714451,0.8606858320218038
"Congo, Rep.",1997,52868421,6038943,46829478,0.8857740994383018
"Congo, Rep.",1998,40118083,5974362,34143721,0.8510805713224134
"Congo, Rep.",1999,10719768,6637090,4082678,0.3808550707440683
"Congo, Rep.",2000,18158426,6564616,11593810,0.6384810005008144
"Congo, Rep.",2001,34139918,6493350,27646568,0.8098018278778526
"Congo, Rep.",2002,41588193,6423271,35164922,0.8455506109630683
"Congo, Rep.",2003,41963545,6354361,35609184,0.8485742565362387
"Congo, Rep.",2004,48319559,6286598,42032961,0.8698953771494479
"Congo, Rep.",2005,49007749,6219966,42787783,0.8730819895441433
"Congo, Rep.",2006,54521123,6154444,48366679,0.8871181725292049
"Congo, Rep.",2007,55401469,6090013,49311456,0.8900748823104312
"Congo, Rep.",2008,71843338,10509880,61333458,0.8537111402034243
"Congo, Rep.",2009,61112676,10385669,50727007,0.8300570408666117
"Congo, Rep.",2010,78437792,10263527,68174265,0.8691507405001916
"Congo, Rep.",2011,154460810,19421639,135039171,0.8742617043119222
"Congo, Rep.",2012,183780098,30406011,153374087,0.834552210326931
"Congo, Rep.",2013,184888851,30008794,154880057,0.8376927876521879
"Congo, Rep.",2014,200095079,29618198,170476881,0.8519793782634705
"Congo, Rep.",2015,178304046,29234111,149069935,0.8360434793498741
"Congo, Rep.",2016,173815917,30093864,143722053,0.8268635892534514
"Congo, Rep.",2017,186123819,33275890,152847929,0.8212163806933276
"Congo, Rep.",2018,173101172,32844579,140256593,0.8102579051284529
"Congo, Rep.",2019,146896053,32420456,114475597,0.7792966159546847
"Congo, Rep.",2020,152510083,32003402,120506681,0.7901555007349907
Costa Rica,1995,232672827,86708717,145964110,0.627336298277753
Costa Rica,1996,256646789,108651707,147995082,0.576648874418608
Costa Rica,1997,318478917,139708733,178770184,0.5613250185725794
Costa Rica,1998,282330374,138064138,144266236,0.5109837597565751
Costa Rica,1999,290098745,150315043,139783702,0.48184869603624103
Costa Rica,2000,356891167,212107845,144783322,0.40567919687404314
Costa Rica,2001,359721035,209535123,150185912,0.41750661592531
Costa Rica,2002,332427944,206948183,125479761,0.3774645401049678
Costa Rica,2003,351666149,211356132,140310017,0.3989864176548878
Costa Rica,2004,409296305,211077467,198218838,0.48429178465219713
Costa Rica,2005,460823171,208554076,252269095,0.5474314463236919
Costa Rica,2006,511618612,238593420,273025192,0.533649843059267
Costa Rica,2007,542507784,272183106,270324678,0.4982871877097343
Costa Rica,2008,618970752,289168032,329802720,0.5328244007238649
Costa Rica,2009,567520462,286542604,280977858,0.4950973168611496
Costa Rica,2010,617388927,290593822,326795105,0.5293180533508337
Costa Rica,2011,652968849,301362397,351606452,0.5384735466913522
Costa Rica,2012,639476469,314630735,324845734,0.5079870014732317
Costa Rica,2013,553234364,317410464,235823900,0.42626401276837533
Costa Rica,2014,540161036,366616142,173544894,0.32128362179755593
Costa Rica,2015,621387245,383764733,237622512,0.3824064847034316
Costa Rica,2016,660384493,499281701,161102792,0.24395302086537637
Costa Rica,2017,753750116,511751317,241998799,0.32105971709064385
Costa Rica,2018,728871139,516198935,212672204,0.2917829951283062
Costa Rica,2019,729604718,509560767,220043951,0.3015933773059839
Costa Rica,2020,706727750,503033234,203694516,0.28822204307104116
Cote d'Ivoire,1995,146671143,54616184,92054959,0.6276282922265084
Cote d'Ivoire,1996,150741484,54024231,96717253,0.6416100626951503
Cote d'Ivoire,1997,144628831,53442143,91186688,0.6304876238680239
Cote d'Ivoire,1998,110342176,52869757,57472419,0.5208563133647102
Cote d'Ivoire,1999,135670109,52306910,83363199,0.6144551634435556
Cote d'Ivoire,2000,121235864,51753444,69482420,0.5731177038504052
Cote d'Ivoire,2001,125194153,51209203,73984950,0.5909617040981139
Cote d'Ivoire,2002,130906734,50674032,80232702,0.6128997305822327
Cote d'Ivoire,2003,171349398,50147781,121201617,0.7073361121467144
Cote d'Ivoire,2004,182409259,49630300,132778959,0.7279178684674115
Cote d'Ivoire,2005,155372292,49121445,106250847,0.6838468148490723
Cote d'Ivoire,2006,169312167,48621070,120691097,0.7128318013908593
Cote d'Ivoire,2007,224089028,48129035,175959993,0.7852235987207727
Cote d'Ivoire,2008,270025773,55283284,214742489,0.795266639232989
Cote d'Ivoire,2009,290444855,54702035,235742820,0.8116612015730146
Cote d'Ivoire,2010,212176381,54130474,158045907,0.744879831841415
Cote d'Ivoire,2011,256255762,53568438,202687324,0.7909571375803834
Cote d'Ivoire,2012,241638203,53015770,188622433,0.7805985587469378
Cote d'Ivoire,2013,230014826,52472313,177542513,0.7718742138821956
Cote d'Ivoire,2014,275375783,62795051,212580732,0.7719659647776653
Cote d'Ivoire,2015,164560753,78967277,85593476,0.5201329869947787
Cote d'Ivoire,2016,186985473,78070451,108915022,0.5824785222753641
Cote d'Ivoire,2017,257247448,154181499,103065949,0.40064906299867353
Cote d'Ivoire,2018,390491171,152251083,238240088,0.6101036481564905
Cote d'Ivoire,2019,430236145,150352840,279883305,0.650534150262991
Cote d'Ivoire,2020,423805051,148486235,275318816,0.6496355231028146
Croatia,1995,130466504,126341345,4125159,0.031618529457951905
Croatia,1996,179491436,126991406,52500030,0.29249323070767563
Croatia,1997,122462201,125903292,-3441091,-0.028099209159240898
Croatia,1998,127525613,124833312,2692301,0.021111845194580637
Croatia,1999,150937412,123781165,27156247,0.17991726928509943
Croatia,2000,120125594,122746555,-2620961,-0.02181850605458817
Croatia,2001,132776731,121729187,11047544,0.08320391620426323
Croatia,2002,117021842,120728776,-3706934,-0.03167728294688781
Croatia,2003,133745316,121705360,12039956,0.09002151522076482
Croatia,2004,210518969,120713869,89805100,0.4265891117868813
Croatia,2005,198991431,119738903,79252528,0.3982710592196304
Croatia,2006,193446161,118780186,74665975,0.38597806549389213
Croatia,2007,153632734,121500740,32131994,0.20914809730587752
Croatia,2008,231030754,120528586,110502168,0.4783006854576599
Croatia,2009,299046279,121576283,177469996,0.5934532828612792
Croatia,2010,348434049,129033937,219400112,0.6296747193039105
Croatia,2011,199891975,127981561,71910414,0.359746378012424
Croatia,2012,201358558,135996994,65361564,0.32460286093228774
Croatia,2013,389602574,149426240,240176334,0.6164649569281336
Croatia,2014,394258210,148136639,246121571,0.6242649227266567
Croatia,2015,233015328,164676427,68338901,0.2932807107007141
Croatia,2016,250488378,163210081,87278297,0.3484325208892526
Croatia,2017,182271401,166330084,15941317,0.08745923338790818
Croatia,2018,299217699,166543137,132674562,0.44340479337754685
Croatia,2019,215644170,165125682,50518488,0.23426781257290658
Croatia,2020,210843540,163679248,47164292,0.22369332254618757
Czechia,1995,15634066,55237040,-39602974,-2.533120558656974
Czechia,1996,16969018,54762853,-37793835,-2.227225818253007
Czechia,1997,14150433,61552441,-47402008,-3.349862721515306
Czechia,1998,17211145,61004546,-43793401,-2.544479231335277
Czechia,1999,20912752,75157795,-54245043,-2.593873967424278
Czechia,2000,23911602,74447022,-50535420,-2.1134267791844312
Czechia,2001,32549962,83846227,-51296265,-1.5759239596040082
Czechia,2002,50180982,83034551,-32853569,-0.6547015959153609
Czechia,2003,30745998,83107657,-52361659,-1.703039823264153
Czechia,2004,50237319,84772018,-34534699,-0.6874311704412411
Czechia,2005,66135055,85112449,-18977394,-0.28694909227791526
Czechia,2006,81921393,84299166,-2377773,-0.029025055762906767
Czechia,2007,80616101,85453194,-4837093,-0.06000157462341177
Czechia,2008,101672895,85886809,15786086,0.15526346525295656
Czechia,2009,122048941,87078171,34970770,0.28653071229843774
Czechia,2010,135455575,89623683,45831892,0.3383536779493941
Czechia,2011,108205898,89059040,19146858,0.17694837669569546
Czechia,2012,110764053,92597652,18166401,0.16400989768765503
Czechia,2013,147295553,96173794,51121759,0.34706926284461553
Czechia,2014,86205673,95253081,-9047408,-0.10495142239652835
Czechia,2015,68152241,96792150,-28639909,-0.42023429574384796
Czechia,2016,78005499,96369041,-18363542,-0.23541342899428155
Czechia,2017,76333574,96180166,-19846592,-0.25999820210173835
Czechia,2018,74601853,95275277,-20673424,-0.27711676276995423
Czechia,2019,96538755,94674731,1864024,0.0193085564445077
Czechia,2020,108878634,93949728,14928906,0.13711511112455727
Dominican Republic,1995,26906910,41258724,-14351814,-0.5333876688181586
Dominican Republic,1996,38991596,40858162,-1866566,-0.047870982249610915
Dominican Republic,1997,30651186,40464275,-9813089,-0.3201536475619573
Dominican Republic,1998,42337879,40625566,1712313,0.04044399578920805
Dominican Republic,1999,54061126,40237124,13824002,0.2557105821288295
Dominican Republic,2000,40666674,39855155,811519,0.019955381647390195
Dominican Republic,2001,32561297,40816990,-8255693,-0.2535431251402547
Dominican Republic,2002,37689753,59768357,-22078604,-0.585798585626178
Dominican Republic,2003,56092074,59218751,-3126677,-0.05574186827179897
Dominican Republic,2004,69116877,58724703,10392174,0.15035653303606294
Dominican Republic,2005,92297250,58094381,34202869,0.37057300190417375
Dominican Republic,2006,94825493,58383726,36441767,0.38430348049970064
Dominican Republic,2007,93323176,57809164,35514012,0.38054868599842767
Dominican Republic,2008,80317721,58196547,22121174,0.2754208377003127
Dominican Republic,2009,79139220,74472800,4666420,0.05896469538112708
Dominican Republic,2010,83467089,73633862,9833227,0.11780963153033887
Dominican Republic,2011,96037145,74105461,21931684,0.22836668041308392
Dominican Republic,2012,109296055,99474902,9821153,0.08985825700662298
Dominican Republic,2013,104839613,98338939,6500674,0.06200589466120979
Dominican Republic,2014,70720750,98161948,-27441198,-0.38802187476801364
Dominican Republic,2015,50325154,97055210,-46730056,-0.928562603106987
Dominican Republic,2016,86450325,96204971,-9754646,-0.11283527274188963
Dominican Republic,2017,132049186,95138418,36910768,0.2795228741508486
Dominican Republic,2018,107549432,94070499,13478933,0.12532779345594314
Dominican Republic,2019,64017347,93868080,-29850733,-0.4662913163208716
Dominican Republic,2020,72684640,94365893,-21681253,-0.29829208757173453
Ecuador,1995,52664,115174496,-115121832,-2185.9682515570407
Ecuador,1996,29274,118034890,-118005616,-4031.072487531598
Ecuador,1997,31422,116760518,-116729096,-3714.884348545605
Ecuador,1998,31258,118613744,-118582486,-3793.6683728965386
Ecuador,1999,24258,154515086,-154490828,-6368.654794294665
Ecuador,2000,222285842,157120339,65165503,0.29316083477777233
Ecuador,2001,336760708,159260660,177500048,0.5270806355473038
Ecuador,2002,520942574,157438032,363504542,0.6977823663151017
Ecuador,2003,542764703,159602786,383161917,0.7059447950136876
Ecuador,2004,581888902,157785761,424103141,0.7288386830240663
Ecuador,2005,535217670,162351078,372866592,0.6966634565708565
Ecuador,2006,556663434,170484242,386179192,0.6937391041208574
Ecuador,2007,695989922,223042845,472947077,0.6795315018943622
Ecuador,2008,844744345,224069259,620675086,0.7347490275297434
Ecuador,2009,666949780,221390761,445559019,0.6680548256571882
Ecuador,2010,636324143,259132808,377191335,0.5927660283667722
Ecuador,2011,839088605,255985277,583103328,0.6949246176451175
Ecuador,2012,939057954,261643679,677414275,0.7213764306180405
Ecuador,2013,836358203,270000135,566358068,0.6771716544041596
Ecuador,2014,913710399,266729408,646980991,0.7080810196623362
Ecuador,2015,1075931605,308052569,767879036,0.7136875916940836
Ecuador,2016,1295249593,779489813,515759780,0.398193354228678
Ecuador,2017,1633723292,786171246,847552046,0.5187855557610548
Ecuador,2018,1678718146,914754381,763963765,0.45508757191929466
Ecuador,2019,2027404036,906046327,1121357709,0.5531002647170423
Ecuador,2020,1960069549,900704702,1059364847,0.5404730906311325
"Egypt, Arab Rep.",1995,187770405,179056347,8714058,0.04640804816925223
"Egypt, Arab Rep.",1996,192023241,191753515,269726,0.0014046528878241358
"Egypt, Arab Rep.",1997,206116190,189850733,16265457,0.07891401932085006
"Egypt, Arab Rep.",1998,218173572,187979664,30193908,0.1383939756003078
"Egypt, Arab Rep.",1999,280777409,194714271,86063138,0.30651731671190113
"Egypt, Arab Rep.",2000,258518000,192786641,65731359,0.2542622138497126
"Egypt, Arab Rep.",2001,237982103,203111298,34870805,0.14652700585640258
"Egypt, Arab Rep.",2002,209785344,201078633,8706711,0.04150295170286061
"Egypt, Arab Rep.",2003,155892995,199196130,-43303135,-0.277774732597831
"Egypt, Arab Rep.",2004,162433759,202900092,-40466333,-0.24912514029795985
"Egypt, Arab Rep.",2005,179978366,200887482,-20909116,-0.11617571858608829
"Egypt, Arab Rep.",2006,199619940,198908416,711524,0.003564393416809964
"Egypt, Arab Rep.",2007,244207716,206578012,37629704,0.15408892321813453
"Egypt, Arab Rep.",2008,318252737,204531577,113721160,0.35732971559644433
"Egypt, Arab Rep.",2009,317948065,202519249,115428816,0.3630429894265908
"Egypt, Arab Rep.",2010,294947142,200540460,94406682,0.320080002673835
"Egypt, Arab Rep.",2011,280257593,220182582,60075011,0.21435640817767246
"Egypt, Arab Rep.",2012,275347413,217971084,57376329,0.20837794833394713
"Egypt, Arab Rep.",2013,308259070,215796444,92462626,0.29995103144896923
"Egypt, Arab Rep.",2014,368585515,213658048,154927467,0.4203297761172194
"Egypt, Arab Rep.",2015,386241869,211555292,174686577,0.4522725033727506
"Egypt, Arab Rep.",2016,390580394,209487582,181092812,0.4636505436061391
"Egypt, Arab Rep.",2017,280376246,207454334,72921912,0.2600859132695571
"Egypt, Arab Rep.",2018,358130015,218173932,139956083,0.39079685348350374
"Egypt, Arab Rep.",2019,475688206,216032252,259655954,0.5458532516149874
"Egypt, Arab Rep.",2020,679417381,213926266,465491115,0.6851327740760286
El Salvador,1995,62999437,59686406,3313031,0.05258826360622874
El Salvador,1996,85452030,58954490,26497540,0.3100867235102548
El Salvador,1997,65074379,58234774,6839605,0.10510442212594914
El Salvador,1998,70332299,61638576,8693723,0.12360925383656235
El Salvador,1999,86496493,60885872,25610621,0.29608854777499477
El Salvador,2000,57339652,61931434,-4591782,-0.08008039532573376
El Salvador,2001,57098091,61478886,-4380795,-0.07672401867165751
El Salvador,2002,54396750,64886266,-10489516,-0.1928335056781885
El Salvador,2003,69552687,69432828,119859,0.0017232835303688555
El Salvador,2004,67694451,68583285,-888834,-0.013130086541362157
El Salvador,2005,84988063,76902950,8085113,0.09513233640823182
El Salvador,2006,103828889,79560894,24267995,0.23373066237856016
El Salvador,2007,97400213,82282409,15117804,0.15521325399976282
El Salvador,2008,113853737,81588234,32265503,0.2833943254756759
El Salvador,2009,84042911,80908676,3134235,0.03729327033900575
El Salvador,2010,116436886,80134938,36301948,0.3117736075490717
El Salvador,2011,112450987,79171792,33279195,0.2959440009183734
El Salvador,2012,103363533,78333809,25029724,0.24215236528341189
El Salvador,2013,100173063,77611980,22561083,0.2252210556844009
El Salvador,2014,100293235,77103565,23189670,0.2312186858864409
El Salvador,2015,74716947,78362269,-3645322,-0.0487884227924891
El Salvador,2016,65911481,77421919,-11510438,-0.17463479541599133
El Salvador,2017,83567085,107846078,-24278993,-0.29053296522189326
El Salvador,2018,80645194,106645691,-26000497,-0.32240603203211343
El Salvador,2019,81131282,105323924,-24192642,-0.2981912944503946
El Salvador,2020,113843080,104024188,9818892,0.08624935305685685
Eswatini,1995,26266382,5647654,20618728,0.7849854616444701
Eswatini,1996,25994362,5580436,20413926,0.7853212939021161
Eswatini,1997,23187904,5514339,17673565,0.7621889843946223
Eswatini,1998,23460867,5449343,18011524,0.7677262737135844
Eswatini,1999,21304129,5385431,15918698,0.7472118667700519
Eswatini,2000,15460165,5322584,10137581,0.6557226911873192
Eswatini,2001,17367787,6734917,10632870,0.6122178951181287
Eswatini,2002,16259879,6653790,9606089,0.5907847776726998
Eswatini,2003,15290870,7925825,7365045,0.4816629138825979
Eswatini,2004,15222424,7828712,7393712,0.4857118682280825
Eswatini,2005,18480785,7733218,10747567,0.5815535974256505
Eswatini,2006,21913931,7639315,14274616,0.6513945854808068
Eswatini,2007,28158276,7546977,20611299,0.7319801467959189
Eswatini,2008,30904221,13815713,17088508,0.55295061473965
Eswatini,2009,43434843,13638605,29796238,0.685998519667724
Eswatini,2010,51546270,13547005,37999265,0.7371874822368331
Eswatini,2011,63969703,13374612,50595091,0.7909227122720892
Eswatini,2012,52116952,13205092,38911860,0.7466257811853617
Eswatini,2013,47116275,13038397,34077878,0.7232719055146019
Eswatini,2014,56737137,14458555,42278582,0.7451659395503161
Eswatini,2015,38956210,14275495,24680715,0.6335502093247778
Eswatini,2016,21124301,14095486,7028815,0.3327359802343282
Eswatini,2017,18435224,13947585,4487639,0.24342741916236005
Eswatini,2018,31927929,13773124,18154805,0.5686183090672746
Eswatini,2019,38107655,13601571,24506084,0.6430750986908012
Eswatini,2020,35688197,13463625,22224572,0.6227429197389827
Ethiopia,1995,105410643,27138180,78272463,0.7425480081740892
Ethiopia,1996,115486392,26844860,88641532,0.7675495828114537
Ethiopia,1997,120258482,64422919,55835563,0.46429625645865047
Ethiopia,1998,127468030,63616377,63851653,0.5009228823886271
Ethiopia,1999,102725776,62823278,39902498,0.38843705595370726
Ethiopia,2000,97929173,62043397,35885776,0.36644622741785027
Ethiopia,2001,125674621,71497171,54177450,0.4310930048478125
Ethiopia,2002,129593574,177364586,-47771012,-0.36862176515017636
Ethiopia,2003,151376524,179952019,-28575495,-0.18877098142377743
Ethiopia,2004,182031241,206527484,-24496243,-0.13457164201830607
Ethiopia,2005,219560622,203783631,15776991,0.07185710650792382
Ethiopia,2006,271028883,201085510,69943373,0.2580661227903153
Ethiopia,2007,295861797,198432356,97429441,0.3293072711242946
Ethiopia,2008,326513568,195823423,130690145,0.40025946180588734
Ethiopia,2009,349499054,259588047,89911007,0.2572567964661787
Ethiopia,2010,479429981,297548593,181881388,0.37937007531450145
Ethiopia,2011,644512352,311233318,333279034,0.5171026326583109
Ethiopia,2012,798504647,307102560,491402087,0.6154029144929948
Ethiopia,2013,941269244,303040648,638228596,0.6780510465717501
Ethiopia,2014,765337352,299046434,466290918,0.6092619376036935
Ethiopia,2015,926674977,313141859,613533118,0.6620801610357933
Ethiopia,2016,991721120,565520675,426200445,0.4297583629155745
Ethiopia,2017,1216594668,791014702,425579966,0.3498124537234944
Ethiopia,2018,1371605916,780337849,591268067,0.4310772213088063
Ethiopia,2019,1525551659,770445729,755105930,0.4949723764156059
Ethiopia,2020,1625567138,835233926,790333212,0.48618921576649143
Finland,1995,337695352,161607192,176088160,0.5214408755024854
Finland,1996,321878472,161832795,160045677,0.49722392431389445
Finland,1997,304025173,169595666,134429507,0.442165711718878
Finland,1998,371220874,172157496,199063378,0.5362397212609332
Finland,1999,292168819,170728550,121440269,0.41565102469062587
Finland,2000,285693493,169529058,116164435,0.4066051129837948
Finland,2001,253971897,177401434,76570463,0.3014918733311662
Finland,2002,228760686,184040678,44720008,0.19548817055042403
Finland,2003,268521145,182925726,85595419,0.3187660286492522
Finland,2004,463947082,188775440,275171642,0.5931099745552446
Finland,2005,417141504,195481908,221659596,0.5313774675367714
Finland,2006,367827234,200230922,167596312,0.45563867084404086
Finland,2007,515519109,208277272,307241837,0.5959853507583557
Finland,2008,742028096,206463213,535564883,0.7217582270631434
Finland,2009,553172859,210439872,342732987,0.6195766502709057
Finland,2010,567111451,211422267,355689184,0.6271945018440476
Finland,2011,664918004,221342151,443575853,0.6671136145081733
Finland,2012,820988113,219398679,601589434,0.7327626605965244
Finland,2013,649497932,225806640,423691292,0.6523366297646657
Finland,2014,675253884,231088172,444165712,0.6577758714528179
Finland,2015,708293837,229355570,478938267,0.6761858454515961
Finland,2016,669658667,227347618,442311049,0.6605022391205757
Finland,2017,675765537,231202239,444563298,0.657866188284177
Finland,2018,662782576,229188853,433593723,0.6542020546418227
Finland,2019,638518446,228529852,409988594,0.6420935786090038
Finland,2020,825676705,228440788,597235917,0.7233290141084942
France,1995,2911238991,1359073639,1552165352,0.5331631503969507
France,1996,2627347836,1357997750,1269350086,0.48312981958739015
France,1997,2103846310,1349908676,753937634,0.35836155446164697
France,1998,1980455095,1339821718,640633377,0.3234778605267998
France,1999,2144399624,1330926271,813473353,0.3793478341889506
France,2000,1690153985,1328197309,361956676,0.21415603501949557
France,2001,1827476698,1322788241,504688457,0.2761668356988265
France,2002,1583408541,1325107084,258301457,0.16313001370882463
France,2003,1867780598,1316311426,551469172,0.29525372122962806
France,2004,2111106973,1305927431,805179542,0.38140158329153506
France,2005,1825156395,1298714440,526441955,0.2884366273718697
France,2006,2025397031,1291490186,733906845,0.3623520888828636
France,2007,2253332468,1284720172,968612296,0.4298576928861791
France,2008,2629141307,1274901942,1354239365,0.515088086514933
France,2009,2282312092,1278669684,1003642408,0.43974810084825156
France,2010,2586268152,1307188631,1279079521,0.49456570078043477
France,2011,2136352316,1336189492,800162824,0.374546285276665
France,2012,2656700740,1330286383,1326414357,0.49927127170522034
France,2013,3503197460,1320121537,2183075923,0.6231666778497835
France,2014,3250402294,1313455092,1936947202,0.5959099910726312
France,2015,2502739586,1303585241,1199154345,0.4791366835398751
France,2016,2774201912,1303951550,1470250362,0.5299723699419034
France,2017,2346869677,1307114942,1039754735,0.4430389745071473
France,2018,3295788099,1302640193,1993147906,0.6047560844718008
France,2019,2833569728,1315040295,1518529433,0.5359068520511806
France,2020,3343213414,1305361677,2037851737,0.6095488036947676
Gabon,1995,48859446,12210363,36649083,0.750092070221181
Gabon,1996,44567809,13094337,31473472,0.7061929384951368
Gabon,1997,43152750,12952058,30200692,0.699855559610917
Gabon,1998,38784267,13072992,25711275,0.6629305383030701
Gabon,1999,38065976,13725293,24340683,0.6394340972631307
Gabon,2000,45786976,14387134,31399842,0.6857810832495249
Gabon,2001,47628237,14228639,33399598,0.7012562316761798
Gabon,2002,54661126,14072786,40588340,0.7425448937879545
Gabon,2003,67490080,13919531,53570549,0.7937544154637245
Gabon,2004,58355954,13768830,44587124,0.7640544099407577
Gabon,2005,55208420,13620641,41587779,0.7532868899345426
Gabon,2006,61844559,13474921,48369638,0.7821163054942311
Gabon,2007,60649191,13331630,47317561,0.7801845370039643
Gabon,2008,79676821,13190728,66486093,0.8344471097811496
Gabon,2009,81655306,13052173,68603133,0.8401552374318455
Gabon,2010,85871932,12915928,72956004,0.8495908069239667
Gabon,2011,92436539,12781954,79654585,0.8617218457302906
Gabon,2012,100045312,12650212,87395100,0.8735551746792494
Gabon,2013,98008634,27759698,70248936,0.7167627292917887
Gabon,2014,81698596,27421868,54276728,0.6643532527780527
Gabon,2015,86468070,27089668,59378402,0.6867090013689446
Gabon,2016,81173770,26763005,54410765,0.6702998394678478
Gabon,2017,89050972,27012291,62038681,0.6966648382007554
Gabon,2018,98375929,49498163,48877766,0.49684680487235855
Gabon,2019,96985700,48864825,48120875,0.4961646407666285
Gabon,2020,91782279,48242043,43540236,0.4743860849216873
Georgia,1995,98625618,170248483,-71622865,-0.7262095432446365
Georgia,1996,163164727,168432695,-5267968,-0.032286193816878084
Georgia,1997,171388418,166647171,4741247,0.027663753801613362
Georgia,1998,174617476,164891405,9726071,0.05569929896363867
Georgia,1999,144450278,163164902,-18714624,-0.12955754920734733
Georgia,2000,140340170,161467174,-21127004,-0.1505413881143225
Georgia,2001,129329824,159797742,-30467918,-0.23558307788310298
Georgia,2002,153337397,158156133,-4818736,-0.031425706280901584
Georgia,2003,146395548,156541885,-10146337,-0.06930768823653025
Georgia,2004,157217671,154954541,2263130,0.014394883129899564
Georgia,2005,167907464,156133464,11774000,0.07012195717517358
Georgia,2006,223491780,154560755,68931025,0.30842756274973515
Georgia,2007,371895763,163628314,208267449,0.5600156541713545
Georgia,2008,440270590,182293074,257977516,0.5859521890844447
Georgia,2009,406701033,181101808,225599225,0.5547053159316662
Georgia,2010,478884675,179203460,299681215,0.6257899461911158
Georgia,2011,407893601,177336751,230556850,0.5652377223735854
Georgia,2012,378001469,176586789,201414680,0.5328409980332642
Georgia,2013,362013197,184745884,177267313,0.4896708586013233
Georgia,2014,342891583,182818415,160073168,0.46683317974591404
Georgia,2015,297848968,180923071,116925897,0.3925677425882503
Georgia,2016,387949931,191471729,196478202,0.5064524731156609
Georgia,2017,359380547,260756588,98623959,0.27442765008646947
Georgia,2018,424943201,257801421,167141780,0.3933273425876038
Georgia,2019,337405228,254895506,82509722,0.24454191919041635
Georgia,2020,273902247,289153929,-15251682,-0.05568293859232196
Germany,1995,991796400,270809587,720986813,0.7269504234941768
Germany,1996,910671489,268432081,642239408,0.70523719668136
Germany,1997,650105810,266094200,384011610,0.5906909369107162
Germany,1998,662686100,272609533,390076567,0.5886294687635669
Germany,1999,688510919,292033504,396477415,0.5758476794759445
Germany,2000,656845570,325001500,331844070,0.5052086596245142
Germany,2001,703426764,322008506,381418258,0.5422288111858081
Germany,2002,786303316,332850039,453453277,0.5766900225052592
Germany,2003,805155185,333271185,471884000,0.586078322280195
Germany,2004,1025786488,361947764,663838724,0.6471509731955057
Germany,2005,1044452430,364086704,680365726,0.6514090124717312
Germany,2006,1110404189,360679406,749724783,0.675181875597193
Germany,2007,1529301085,357328896,1171972189,0.7663449666616826
Germany,2008,1659729554,360752270,1298977284,0.7826439439301567
Germany,2009,1518341899,384274425,1134067474,0.7469117955230714
Germany,2010,1671157352,392464260,1278693092,0.7651542151130721
Germany,2011,1555606075,427929976,1127676099,0.7249110922892223
Germany,2012,1841652242,423826011,1417826231,0.7698664268234849
Germany,2013,2229685997,419790446,1809895551,0.8117266527372823
Germany,2014,1936962714,415822140,1521140574,0.7853225893330231
Germany,2015,1551974431,414669964,1137304467,0.7328113429466674
Germany,2016,1690367592,420744589,1269623003,0.7510928445438393
Germany,2017,1734575271,416815579,1317759692,0.759701648023783
Germany,2018,1563761967,412952053,1150809914,0.7359239694310842
Germany,2019,1647276324,422097039,1225179285,0.7437606351464807
Germany,2020,1582372155,427631767,1154740388,0.7297527224245172
Ghana,1995,771105935,80691707,690414228,0.8953558735091307
Ghana,1996,820060248,79843587,740216661,0.9026369255250134
Ghana,1997,795924812,79009603,716915209,0.9007323282189624
Ghana,1998,449275616,78189519,371086097,0.8259653624291063
Ghana,1999,583268258,87901017,495367241,0.8492957300618269
Ghana,2000,674106067,86962793,587143274,0.8709953859531129
Ghana,2001,670023473,90111623,579911850,0.8655097520740143
Ghana,2002,528663919,89148188,439515731,0.8313707730071135
Ghana,2003,476670251,88200811,388469440,0.8149647249540647
Ghana,2004,701321917,104146723,597175194,0.8514994035185699
Ghana,2005,776678687,102997592,673681095,0.8673871271042101
Ghana,2006,823200846,101867613,721333233,0.876254241604606
Ghana,2007,616730217,100756467,515973750,0.8366279708328285
Ghana,2008,1186568907,99663840,1086905067,0.916006698463067
Ghana,2009,1274323464,98589423,1175734041,0.9226339106316573
Ghana,2010,1277856497,97532914,1180323583,0.9236745955207206
Ghana,2011,1476644569,96494013,1380150556,0.9346531893823665
Ghana,2012,1502673662,95472427,1407201235,0.9364649628097361
Ghana,2013,1590668180,170663025,1420005155,0.892709851654919
Ghana,2014,1616682656,168622990,1448059666,0.8956981511651722
Ghana,2015,949001000,167335766,781665234,0.8236716652564118
Ghana,2016,855806203,165353238,690452965,0.80678658623838
Ghana,2017,868923370,163403753,705519617,0.8119468774329317
Ghana,2018,973252719,161486758,811765961,0.8340752048800595
Ghana,2019,1125539045,159601714,965937331,0.8581997535234328
Ghana,2020,1142871678,157758336,985113342,0.8619632115863842
Greece,1995,93474388,159021302,-65546914,-0.7012285975063031
Greece,1996,113092002,157609570,-44517568,-0.39364028589749434
Greece,1997,93104511,180703874,-87599363,-0.940871307513768
Greece,1998,90902821,194613077,-103710256,-1.1408915021460115
Greece,1999,101654861,205392960,-103738099,-1.0204932452762883
Greece,2000,71856703,217588686,-145731983,-2.0280917007839894
Greece,2001,47833996,216332865,-168498869,-3.5225756384643256
Greece,2002,66720235,214687199,-147966964,-2.217722464556667
Greece,2003,128019827,212861554,-84841727,-0.6627233373780453
Greece,2004,139202809,215322086,-76119277,-0.5468228518290892
Greece,2005,157566998,214902713,-57335715,-0.3638814963016558
Greece,2006,195050230,219541064,-24490834,-0.12556167711260838
Greece,2007,117566792,221380578,-103813786,-0.8830196370417251
Greece,2008,130678064,225768138,-95090074,-0.7276666878076798
Greece,2009,204463184,229902869,-25439685,-0.12442183723403231
Greece,2010,296025146,231664948,64360198,0.21741463139080758
Greece,2011,173643600,232063388,-58419788,-0.33643501977613915
Greece,2012,198165854,233390658,-35224804,-0.1777541553652326
Greece,2013,343498763,231801926,111696837,0.3251739133628263
Greece,2014,264150482,258285677,5864805,0.022202514852878445
Greece,2015,299215925,256731569,42484356,0.14198561122707623
Greece,2016,263732304,254290685,9441619,0.03580000954300994
Greece,2017,198980001,251890482,-52910481,-0.2659085372102295
Greece,2018,281325548,253942763,27382785,0.09733486771702654
Greece,2019,185314575,252360041,-67045466,-0.36179273001057793
Greece,2020,163889648,251353246,-87463598,-0.5336737192821355
Guatemala,1995,84819135,50310346,34508789,0.40685146105298053
Guatemala,1996,103917348,66869436,37047912,0.3565132551304138
Guatemala,1997,96931497,66097916,30833581,0.31809661414803075
Guatemala,1998,74166604,68658815,5507789,0.07426238634305003
Guatemala,1999,81522206,67866956,13655250,0.1675034407189619
Guatemala,2000,108017179,71987946,36029233,0.3335509530386829
Guatemala,2001,92446329,71154601,21291728,0.2303144779280527
Guatemala,2002,73846640,71165437,2681203,0.03630771826585475
Guatemala,2003,95578528,89977307,5601221,0.05860334028161639
Guatemala,2004,138335357,104577450,33757907,0.24402949276373356
Guatemala,2005,163505397,118084378,45421019,0.2777952277624206
Guatemala,2006,182773203,126474925,56298278,0.30802260438583
Guatemala,2007,167087024,135336728,31750296,0.1900225118618427
Guatemala,2008,212031452,133925087,78106365,0.36837159894561305
Guatemala,2009,158841955,132750561,26091394,0.16426009110754144
Guatemala,2010,224395434,157744972,66650462,0.2970223627634063
Guatemala,2011,262279811,164275513,98004298,0.3736631410032547
Guatemala,2012,272436975,183245349,89191626,0.3273844381806104
Guatemala,2013,259964115,184129485,75834630,0.29171191570036503
Guatemala,2014,269714545,183925542,85789003,0.3180733282292952
Guatemala,2015,206400994,207559981,-1158987,-0.005615220050732895
Guatemala,2016,225902744,315730692,-89827948,-0.3976399153433922
Guatemala,2017,347762517,321761903,26000614,0.07476542965094769
Guatemala,2018,315152802,367056920,-51904118,-0.1646950865440822
Guatemala,2019,286803094,391179790,-104376696,-0.36393155507590164
Guatemala,2020,347920307,390320505,-42400198,-0.12186755744613666
Guinea,1995,13656140,2965870,10690270,0.7828178387157718
Guinea,1996,21032289,2935679,18096610,0.8604203755473311
Guinea,1997,22116502,2905991,19210511,0.8686053065715365
Guinea,1998,33340276,5249019,28091257,0.8425622211405809
Guinea,1999,27568374,17923183,9645191,0.34986434092921115
Guinea,2000,30154867,17686868,12467999,0.41346556096566434
Guinea,2001,34530253,17454493,17075760,0.4945159249195191
Guinea,2002,37806987,20931060,16875927,0.44637058753187603
Guinea,2003,26344494,20655201,5689293,0.21595757352561032
Guinea,2004,39750106,20383939,19366167,0.4871978706169991
Guinea,2005,36677784,20117198,16560586,0.4515154459713269
Guinea,2006,37976477,19854902,18121575,0.4771789389521308
Guinea,2007,43264871,19596979,23667892,0.5470464016869483
Guinea,2008,49015421,19343354,29672067,0.6053618717260432
Guinea,2009,45825633,19093956,26731677,0.5833345935450581
Guinea,2010,46153539,18848715,27304824,0.5916084571542823
Guinea,2011,42640533,18607561,24032972,0.5636180016792942
Guinea,2012,53012615,18713823,34298792,0.6469930223211966
Guinea,2013,54435684,18475898,35959786,0.6605921586288876
Guinea,2014,47783507,18241939,29541568,0.6182377530389304
Guinea,2015,90507551,65224483,25283068,0.27934760935029607
Guinea,2016,111106800,64346273,46760527,0.4208610724096095
Guinea,2017,125466694,63482701,61983993,0.4940274667634105
Guinea,2018,127795071,62633522,65161549,0.5098909409424719
Guinea,2019,142958323,61798496,81159827,0.5677166974041798
Guinea,2020,164968379,126781761,38186618,0.23147840956841795
Haiti,1995,15633446,10775457,4857989,0.3107433255598286
Haiti,1996,17809477,10640989,7168488,0.40250974242533905
Haiti,1997,13140684,10508762,2631922,0.20028805197659422
Haiti,1998,19828720,10378739,9449981,0.47658048527590285
Haiti,1999,28604026,10250883,18353143,0.6416279652381801
Haiti,2000,19924100,10125157,9798943,0.4918135825457612
Haiti,2001,20030996,10137862,9893134,0.4938912673139169
Haiti,2002,17915029,10014410,7900619,0.4410050913118812
Haiti,2003,17456909,9893015,7563894,0.43328942139756815
Haiti,2004,18298191,9773644,8524547,0.465868292663466
Haiti,2005,19467879,9656262,9811617,0.5039900340453113
Haiti,2006,20693666,9540837,11152829,0.5389489228249842
Haiti,2007,12445682,9427335,3018347,0.24252162316215375
Haiti,2008,14587639,9315725,5271914,0.3613959736733271
Haiti,2009,16677989,9205975,7472014,0.4480164844814324
Haiti,2010,14269633,9098055,5171578,0.36241843080337105
Haiti,2011,9761815,8991933,769882,0.07886668616440692
Haiti,2012,17846565,8887580,8958985,0.5020005250310073
Haiti,2013,11386279,11378605,7674,0.0006739690815586023
Haiti,2014,7272696,11241885,-3969189,-0.5457658342930874
Haiti,2015,6270581,11107443,-4836862,-0.7713578693904122
Haiti,2016,5025777,10975241,-5949464,-1.18378988960314
Haiti,2017,8995181,10845243,-1850062,-0.20567257067978956
Haiti,2018,14060997,15156068,-1095071,-0.07788003937416386
Haiti,2019,14345080,18501472,-4156392,-0.28974338240009817
Haiti,2020,12098099,18268812,-6170713,-0.5100564146482848
Honduras,1995,129247207,34311347,94935860,0.7345292962500922
Honduras,1996,141205445,33942490,107262955,0.7596233629659253
Honduras,1997,90480493,33579780,56900713,0.6288727118230888
Honduras,1998,124528936,66905602,57623334,0.4627304773566844
Honduras,1999,150338252,66350670,83987582,0.558657433372313
Honduras,2000,159653997,65544805,94109192,0.5894571621655047
Honduras,2001,151865745,64956873,86908872,0.572274359830125
Honduras,2002,140431093,72311692,68119401,0.48507349437207614
Honduras,2003,133993761,71601104,62392657,0.46563852327422917
Honduras,2004,131933481,72079833,59853648,0.4536653436742111
Honduras,2005,126210627,73775627,52435000,0.4154562990959549
Honduras,2006,158058374,80305840,77752534,0.4919229018514388
Honduras,2007,178934972,84689295,94245677,0.5267035054500134
Honduras,2008,184646466,84343188,100303278,0.5432179676810062
Honduras,2009,225338168,84041861,141296307,0.6270411633061648
Honduras,2010,248319833,83764456,164555377,0.6626751275239461
Honduras,2011,227099351,83829621,143269730,0.6308680732425342
Honduras,2012,225040349,85394979,139645370,0.6205348090710613
Honduras,2013,221192605,90559865,130632740,0.5905836680209088
Honduras,2014,210768396,110384263,100384133,0.4762769699115611
Honduras,2015,178317571,118115572,60201999,0.33761114321145613
Honduras,2016,158997199,122491565,36505634,0.22959922709078667
Honduras,2017,210119681,126426681,83693000,0.39831109395221287
Honduras,2018,223850613,137535403,86315210,0.38559291325237516
Honduras,2019,185719691,142266029,43453662,0.2339744470068066
Honduras,2020,212728943,185876009,26852934,0.12623074989847527
Iceland,1995,128510935,46180828,82330107,0.6406467045002824
Iceland,1996,130299686,45845131,84454555,0.6481562434463579
Iceland,1997,135766695,53163111,82603584,0.608423030405211
Iceland,1998,144766330,59287075,85479255,0.5904636457938803
Iceland,1999,155072088,66140647,88931441,0.5734845138604182
Iceland,2000,155835940,75436574,80399366,0.5159231304408983
Iceland,2001,126260303,84216835,42043468,0.3329903936631611
Iceland,2002,144051193,93247675,50803518,0.3526768292713827
Iceland,2003,180990798,92347955,88642843,0.48976436360040804
Iceland,2004,206959779,93252276,113707503,0.5494183630723726
Iceland,2005,222059007,92360257,129698750,0.5840733584834953
Iceland,2006,207512245,91483105,116029140,0.5591435821052392
Iceland,2007,277447837,179114076,98333761,0.3544225179884895
Iceland,2008,317328927,195510679,121818248,0.38388636406916665
Iceland,2009,231379576,193378825,38000751,0.16423554601033585
Iceland,2010,268963647,193528463,75435184,0.280466095851236
Iceland,2011,324702092,191725974,132976118,0.40953268018981537
Iceland,2012,315476540,189668210,125808330,0.39878822685198717
Iceland,2013,351402225,207567062,143835163,0.40931773553795797
Iceland,2014,378057467,205331898,172725569,0.45687649121343765
Iceland,2015,366215039,204050650,162164389,0.4428119321445999
Iceland,2016,455067503,201878078,253189425,0.5563777315032754
Iceland,2017,612859197,201705492,411153705,0.6708779227147668
Iceland,2018,597549494,215423345,382126149,0.6394886998264281
Iceland,2019,532026893,214654563,317372330,0.596534374814019
Iceland,2020,480100469,215055761,265044708,0.5520609228982027
India,1995,1723207954,836231877,886976077,0.5147237597999156
India,1996,1572108212,917434034,654674178,0.41643073485834575
India,1997,1745028375,944149251,800879124,0.4589490551980279
India,1998,1792941871,1013631409,779310462,0.4346546168645977
India,1999,1757475489,1196466949,561008540,0.3192127250202577
India,2000,1656016923,1359743218,296273705,0.17890741385859618
India,2001,1645161504,1499573390,145588114,0.08849472446688128
India,2002,1533459579,1526208404,7251175,0.004728637845627883
India,2003,1766941830,1907430146,-140488316,-0.07950930450268416
India,2004,2164128916,2111677481,52451435,0.024236742373438164
India,2005,2728934308,2391053308,337881000,0.12381426662030151
India,2006,3235649038,2737171854,498477184,0.15405786540684763
India,2007,3987233532,2887491424,1099742108,0.2758158254774629
India,2008,3886577355,2996970020,889607335,0.22889222411990304
India,2009,3455627928,2966677663,488950265,0.14149389783494076
India,2010,4181104072,3101541072,1079563000,0.25820046126802076
India,2011,4503810666,3374772545,1129038121,0.250685076422793
India,2012,4674639586,3442281105,1232358481,0.2636264161820667
India,2013,5025075515,3568377759,1456697756,0.28988574433393366
India,2014,5230882219,3650334434,1580547785,0.30215702033187
India,2015,4859727139,3809449163,1050277976,0.2161187132444886
India,2016,4605190416,4195683295,409507121,0.08892295084633912
India,2017,4866740863,4386949770,479791093,0.09858570787026513
India,2018,5034633185,4400671271,633961914,0.12592017942614026
India,2019,5654819984,4393015421,1261804563,0.2231378835347909
India,2020,5743988181,4434227679,1309760502,0.22802284070368284
Indonesia,1995,354586509,178782755,175803754,0.4957993311584226
Indonesia,1996,379534844,180141879,199392965,0.5253614210978742
Indonesia,1997,281089338,218419028,62670310,0.22295513037210968
Indonesia,1998,140715079,319468732,-178753653,-1.2703233674054222
Indonesia,1999,283503031,321031092,-37528061,-0.13237269763087647
Indonesia,2000,233757229,319842601,-86085372,-0.3682682771705854
Indonesia,2001,230500983,316009530,-85508547,-0.3709682530941744
Indonesia,2002,335334909,321507991,13826918,0.04123316013007163
Indonesia,2003,442977316,320225105,122752211,0.2771072164787779
Indonesia,2004,482880238,323706471,159173767,0.3296340468586333
Indonesia,2005,498583483,339819796,158763687,0.31842949558760253
Indonesia,2006,477109692,391179339,85930353,0.1801060729657112
Indonesia,2007,564741819,386387833,178353986,0.31581508576045436
Indonesia,2008,558981913,399802598,159179315,0.28476648581650976
Indonesia,2009,516363815,394911582,121452233,0.23520670789063713
Indonesia,2010,946404224,408996195,537408029,0.5678419594627676
Indonesia,2011,699965393,403998035,295967358,0.42283141560971427
Indonesia,2012,688738030,479973378,208764652,0.30311184065151736
Indonesia,2013,863551500,582989323,280562177,0.3248933931560538
Indonesia,2014,868176341,626830211,241346130,0.2779920606014303
Indonesia,2015,783300151,678547669,104752482,0.13373223772045462
Indonesia,2016,1017952198,669790945,348161253,0.3420212203323913
Indonesia,2017,1176567092,821053745,355513347,0.3021615591811912
Indonesia,2018,1133439523,867936942,265502581,0.23424503523334433
Indonesia,2019,1127891955,895711744,232180211,0.20585323795487132
Indonesia,2020,1070711149,912302286,158408863,0.14794733682183783
"Iran, Islamic Rep.",1995,292039847,97750005,194289842,0.6652853848399667
"Iran, Islamic Rep.",1996,308330654,98168723,210161931,0.6816121857283771
"Iran, Islamic Rep.",1997,286416281,99976455,186439826,0.6509400420571763
"Iran, Islamic Rep.",1998,303494258,98837319,204656939,0.6743354564553244
"Iran, Islamic Rep.",1999,207639642,97717169,109922473,0.5293905919949525
"Iran, Islamic Rep.",2000,144452388,96615688,47836700,0.3311589421422372
"Iran, Islamic Rep.",2001,193715655,95532565,98183090,0.5068412772318273
"Iran, Islamic Rep.",2002,316436496,203717615,112718881,0.3562132763598798
"Iran, Islamic Rep.",2003,485116565,352452317,132664248,0.2734688064094451
"Iran, Islamic Rep.",2004,510002294,413117732,96884562,0.18996887492431552
"Iran, Islamic Rep.",2005,780598757,525927391,254671366,0.326251308647677
"Iran, Islamic Rep.",2006,943217363,581487960,361729403,0.3835058780613223
"Iran, Islamic Rep.",2007,1000824203,676989077,323835126,0.3235684399211117
"Iran, Islamic Rep.",2008,301298385,698915576,-397617191,-1.3196791313700535
"Iran, Islamic Rep.",2009,430794623,694244729,-263450106,-0.6115445549560631
"Iran, Islamic Rep.",2010,545086048,744062745,-198976697,-0.365037222526745
"Iran, Islamic Rep.",2011,713433741,754236435,-40802694,-0.057191988064382845
"Iran, Islamic Rep.",2012,688462515,823192651,-134730136,-0.1956971266620086
"Iran, Islamic Rep.",2013,823657164,854064796,-30407632,-0.03691782616486779
"Iran, Islamic Rep.",2014,831370736,885441432,-54070696,-0.06503800730363932
"Iran, Islamic Rep.",2015,762971144,874491203,-111520059,-0.1461655003298526
"Iran, Islamic Rep.",2016,885814372,913712045,-27897673,-0.03149381392064386
"Iran, Islamic Rep.",2017,787473074,975310446,-187837372,-0.23853180280294892
"Iran, Islamic Rep.",2018,841770177,977635839,-135865662,-0.1614046989455175
"Iran, Islamic Rep.",2019,1277838646,980862357,296976289,0.23240515532193412
"Iran, Islamic Rep.",2020,1081737458,969129840,112607618,0.10409884317789798
Iraq,1995,25268863,18577985,6690878,0.2647874579873261
Iraq,1996,26584361,18418841,8165520,0.30715502245850484
Iraq,1997,27920580,18262349,9658231,0.345917993107593
Iraq,1998,29378293,18108465,11269828,0.3836107155715276
Iraq,1999,30154506,17957146,12197360,0.4044954342810325
Iraq,2000,30656648,127581527,-96924879,-3.1616267701543888
Iraq,2001,31558142,125919295,-94361153,-2.990073148159356
Iraq,2002,33747838,124284767,-90536929,-2.6827475288935547
Iraq,2003,22882895,128092323,-105209428,-4.59773241104327
Iraq,2004,26929628,188147073,-161217445,-5.9866198300251305
Iraq,2005,280626746,185667200,94959546,0.33838380465702295
Iraq,2006,298531159,204686833,93844326,0.314353537883126
Iraq,2007,286142680,204906829,81235851,0.283899804810663
Iraq,2008,249661723,257207018,-7545295,-0.0302220737297403
Iraq,2009,229398072,253802895,-24404823,-0.10638634748421076
Iraq,2010,355200020,250455508,104744512,0.29488881222472907
Iraq,2011,321354858,247163911,74190947,0.2308692249488259
Iraq,2012,356314816,243927173,112387643,0.31541669881052603
Iraq,2013,385911481,240744381,145167100,0.37616683396885
Iraq,2014,237774422,237614635,159787,0.0006720108860153174
Iraq,2015,207609059,234537052,-26927993,-0.12970528901631406
Iraq,2016,273487639,231510762,41976877,0.15348729161393654
Iraq,2017,176535076,228534911,-51999835,-0.2945580911070613
Iraq,2018,147464193,225608656,-78144463,-0.5299216129030049
Iraq,2019,402653367,222731173,179922194,0.4468413994412221
Iraq,2020,400754068,219901648,180852420,0.45128030989818924
Ireland,1995,23993105,10414339,13578766,0.5659445078075556
Ireland,1996,24169521,11316033,12853488,0.5318056572159622
Ireland,1997,21190917,11439170,9751747,0.4601852293602962
Ireland,1998,26563822,11365002,15198820,0.572162394402432
Ireland,1999,23172069,11895195,11276874,0.4866580537111295
Ireland,2000,21512952,11816049,9696903,0.45074720568334836
Ireland,2001,14065039,12158977,1906062,0.13551771879196353
Ireland,2002,24448677,12504340,11944337,0.48854737620362854
Ireland,2003,21866491,12418728,9447763,0.4320658033335115
Ireland,2004,27234039,12334542,14899497,0.5470909768470259
Ireland,2005,30428236,12251760,18176476,0.5973555614594287
Ireland,2006,36146142,12170357,23975785,0.6633013559234067
Ireland,2007,40604006,12090312,28513694,0.7022384441574558
Ireland,2008,65075021,12011600,53063421,0.8154191913361042
Ireland,2009,57717367,11934200,45783167,0.7932303460759047
Ireland,2010,34871506,12700325,22171181,0.6357964866788375
Ireland,2011,45870734,12615108,33255626,0.7249856956725392
Ireland,2012,54195950,12531312,41664638,0.768777703869016
Ireland,2013,43873921,12448912,31425009,0.7162571359874582
Ireland,2014,54162032,12367885,41794147,0.7716502770797078
Ireland,2015,50906645,12288209,38618436,0.7586128687129156
Ireland,2016,41391644,12209861,29181783,0.7050162829966358
Ireland,2017,41598543,12132819,29465724,0.708335481846083
Ireland,2018,44592751,12057060,32535691,0.7296183857326946
Ireland,2019,57308566,11982564,45326002,0.7909114668826297
Ireland,2020,61070017,11909310,49160707,0.8049892470146193
Italy,1995,1779894685,1009612758,770281927,0.4327682606681867
Italy,1996,1929820986,1007323803,922497183,0.4780221531905343
Italy,1997,1687677316,1005760020,681917296,0.404056681650629
Italy,1998,1730310821,1010373261,719937560,0.41607412452285647
Italy,1999,1740302645,1046745554,693557091,0.3985267120018656
Italy,2000,1500220130,1037408225,462811905,0.30849599718409326
Italy,2001,1729341674,1036810500,692531174,0.4004594259260302
Italy,2002,1541491961,1040810501,500681460,0.3248031599692527
Italy,2003,1711091573,1051033048,660058525,0.38575289330818296
Italy,2004,2027567184,1053106677,974460507,0.4806057795222237
Italy,2005,1783609569,1078860870,704748699,0.3951249820862561
Italy,2006,2090253633,1080808113,1009445520,0.48292968090729305
Italy,2007,2113764751,1082322508,1031442243,0.4879645393424389
Italy,2008,3142085081,1096962536,2045122545,0.6508807025521789
Italy,2009,3589292130,1101860371,2487431759,0.6930145747150428
Italy,2010,3381814882,1118463925,2263350957,0.6692710973172659
Italy,2011,3237103057,1147659575,2089443482,0.6454670874570182
Italy,2012,3039345008,1163731192,1875613816,0.617111190425276
Italy,2013,4116654987,1177504851,2939150136,0.7139656214284542
Italy,2014,4749281949,1179272685,3570009264,0.751694530317724
Italy,2015,3121875247,1192286918,1929588329,0.6180863027291879
Italy,2016,2858339071,1193210276,1665128795,0.582551178722631
Italy,2017,2387373228,1208021223,1179352005,0.4939956564680049
Italy,2018,3413360359,1208514374,2204845985,0.6459458577780947
Italy,2019,3350260946,1209216012,2141044934,0.6390681109649899
Italy,2020,3424746946,1222915781,2201831165,0.6429179147299253
Japan,1995,10470174532,1709754900,8760419632,0.8367023496337644
Japan,1996,8640104972,1695916710,6944188262,0.8037157285130262
Japan,1997,8735774411,1683048400,7052726011,0.8073383857210504
Japan,1998,8038379062,1692218581,6346160481,0.78948260987098
Japan,1999,8525712767,1683202486,6842510281,0.8025733997848159
Japan,2000,8280208602,1734590963,6545617639,0.7905136154926063
Japan,2001,7000553046,2560019991,4440533055,0.6343117502033996
Japan,2002,6476618844,2539224206,3937394638,0.607939842198316
Japan,2003,8495468871,2557383214,5938085657,0.6989709158102099
Japan,2004,8850531489,2529827432,6320704057,0.7141609591306206
Japan,2005,7008686816,2512249363,4496437453,0.6415520583306943
Japan,2006,7623638910,2492048537,5131590373,0.6731156123185273
Japan,2007,6293525878,2460359445,3833166433,0.6090650149544042
Japan,2008,7681324552,2435803238,5245521314,0.6828928108023002
Japan,2009,8638341192,2405067677,6233273515,0.7215822316410305
Japan,2010,9394674461,2463709071,6930965390,0.7377547161184173
Japan,2011,10706606723,2432725156,8273881567,0.7727828042124678
Japan,2012,10232439387,2412421123,7820018264,0.764237926875491
Japan,2013,9285493924,2382316796,6903177128,0.7434367180142694
Japan,2014,9722894169,2364372654,7358521515,0.7568241911406945
Japan,2015,9018230706,2381592671,6636638035,0.7359135346342957
Japan,2016,8165003940,2370632821,5794371119,0.7096593169555776
Japan,2017,8733923521,2341411898,6392511623,0.7319175176688613
Japan,2018,8900962873,2319680750,6581282123,0.7393899083618838
Japan,2019,9332121442,2291326109,7040795333,0.7544688929263508
Japan,2020,9250750394,2263444045,6987306349,0.7553231955682146
Kazakhstan,1995,215416833,166419055,48997778,0.22745566034758297
Kazakhstan,1996,176458124,164417503,12040621,0.06823500515057046
Kazakhstan,1997,199869826,162449310,37420516,0.18722443877046252
Kazakhstan,1998,229630684,160513920,69116764,0.3009909773207835
Kazakhstan,1999,154034499,158610786,-4576287,-0.029709493845271637
Kazakhstan,2000,161601413,156739372,4862041,0.030086624304454565
Kazakhstan,2001,166999592,173014024,-6014432,-0.03601465086214103
Kazakhstan,2002,178987853,170946738,8041115,0.04492547882564969
Kazakhstan,2003,181951184,169223644,12727540,0.06995030051576911
Kazakhstan,2004,190745852,167538297,23207555,0.12166741639026572
Kazakhstan,2005,197780012,165563804,32216208,0.1628890992280858
Kazakhstan,2006,221305401,163847646,57457755,0.25963105618014265
Kazakhstan,2007,284261963,161935214,122326749,0.43033104995479116
Kazakhstan,2008,306837038,161469955,145367083,0.4737598953096399
Kazakhstan,2009,258191163,159838041,98353122,0.3809314031402384
Kazakhstan,2010,361481771,164795501,196686270,0.5441111717912879
Kazakhstan,2011,390356517,163104759,227251758,0.5821646318255268
Kazakhstan,2012,383192220,217458828,165733392,0.43250719443103514
Kazakhstan,2013,419830003,217959126,201870877,0.4808395673426894
Kazakhstan,2014,404368899,232254418,172114481,0.4256372867093322
Kazakhstan,2015,349818089,230004632,119813457,0.34250217689571794
Kazakhstan,2016,298307976,232507800,65800176,0.22057799755243554
Kazakhstan,2017,314709650,238820300,75889350,0.2411408420428163
Kazakhstan,2018,294957135,245047674,49909461,0.16920920051654284
Kazakhstan,2019,236942493,248929193,-11986700,-0.05058906846227874
Kazakhstan,2020,220504807,248030230,-27525423,-0.12482912900851181
Kenya,1995,324899284,41893311,283005973,0.8710575459439917
Kenya,1996,328942452,41465864,287476588,0.8739418893855634
Kenya,1997,316812428,41045542,275766886,0.870442134296575
Kenya,1998,333408035,40632224,292775811,0.8781306395330275
Kenya,1999,215017808,40225796,174792012,0.8129187699653231
Kenya,2000,147293463,53748044,93545419,0.6350955235535469
Kenya,2001,195412864,53443582,141969282,0.7265093970476785
Kenya,2002,226116239,52864210,173252029,0.7662078131416293
Kenya,2003,226386634,52294494,174092140,0.7690036152929417
Kenya,2004,208071775,51734273,156337502,0.751363331235099
Kenya,2005,232167458,51645076,180522382,0.7775524767988802
Kenya,2006,284966589,51096998,233869591,0.8206912670734182
Kenya,2007,361417215,50558055,310859160,0.8601116579352757
Kenya,2008,406830910,60788671,346042239,0.8505800087805521
Kenya,2009,324515762,63963150,260552612,0.8028966309500862
Kenya,2010,447692637,65265864,382426773,0.8542172495010232
Kenya,2011,491194893,65717994,425476899,0.8662079045679328
Kenya,2012,616945715,78704912,538240803,0.8724281406184984
Kenya,2013,660888660,78625882,582262778,0.8810300633695243
Kenya,2014,553691509,83170472,470521037,0.8497891503696511
Kenya,2015,470187363,83732438,386454925,0.8219168684888709
Kenya,2016,506310750,82761927,423548823,0.8365392656584913
Kenya,2017,399170841,88347051,310823790,0.7786735855287586
Kenya,2018,480157044,87318315,392838729,0.8181463417206476
Kenya,2019,457639523,88572058,369067465,0.8064588971263306
Kenya,2020,517912300,88050303,429861997,0.8299899365201405
"Korea, Rep.",1995,191331631,101226161,90105470,0.47093870223685075
"Korea, Rep.",1996,179154001,100150754,79003247,0.44097952911473076
"Korea, Rep.",1997,179421689,100924052,78497637,0.43750361195184156
"Korea, Rep.",1998,143883448,101248021,42635427,0.29631919162793485
"Korea, Rep.",1999,168489076,101684661,66804415,0.3964910757775181
"Korea, Rep.",2000,204946635,100620014,104326621,0.5090428588886078
"Korea, Rep.",2001,179606821,109806107,69800714,0.38863064114920226
"Korea, Rep.",2002,142803423,108535632,34267791,0.23996477311331676
"Korea, Rep.",2003,230005998,107492824,122513174,0.5326520832730631
"Korea, Rep.",2004,218270123,106685421,111584702,0.5112229766783061
"Korea, Rep.",2005,207485272,106342991,101142281,0.4874672791233105
"Korea, Rep.",2006,214437428,105584757,108852671,0.5076197379125439
"Korea, Rep.",2007,233448985,106010086,127438899,0.5458961365799042
"Korea, Rep.",2008,171671117,107878085,63793032,0.3716002616794297
"Korea, Rep.",2009,136166947,109030322,27136625,0.1992893693944684
"Korea, Rep.",2010,207505730,109919469,97586261,0.47028224714565714
"Korea, Rep.",2011,313850602,125785228,188065374,0.5992194145926794
"Korea, Rep.",2012,274666971,130724757,143942214,0.5240608780733232
"Korea, Rep.",2013,313661421,130314445,183346976,0.5845378606507047
"Korea, Rep.",2014,206216074,132224989,73991085,0.3588036740530712
"Korea, Rep.",2015,147965375,131601509,16363866,0.11059253558476097
"Korea, Rep.",2016,187901442,134191838,53709604,0.28583923267603234
"Korea, Rep.",2017,170564798,133824564,36740234,0.2154033800104521
"Korea, Rep.",2018,205724869,132572356,73152513,0.3555842001775682
"Korea, Rep.",2019,158479285,136983517,21495768,0.13563771441800737
"Korea, Rep.",2020,223438666,135386257,88052409,0.39407865512408674
Lao PDR,1995,15211463,9312026,5899437,0.3878283765341966
Lao PDR,1996,17275664,9473612,7802052,0.4516209622970208
Lao PDR,1997,15726586,9379787,6346799,0.40357131547813363
Lao PDR,1998,20312204,39735634,-19423430,-0.9562443346866741
Lao PDR,1999,27585709,60543078,-32957369,-1.194726189564314
Lao PDR,2000,40820301,68337200,-27516899,-0.6740983855067605
Lao PDR,2001,55292155,67648944,-12356789,-0.22348177603133754
Lao PDR,2002,56521091,66733413,-10212322,-0.180681614939103
Lao PDR,2003,60721058,65833140,-5112082,-0.08418960684117197
Lao PDR,2004,89087418,65477889,23609529,0.2650153021608506
Lao PDR,2005,97813324,73486891,24326433,0.2487026511848222
Lao PDR,2006,120525285,72497028,48028257,0.39849112989029645
Lao PDR,2007,114384869,71523664,42861205,0.3747104435639997
Lao PDR,2008,141531973,70566522,70965451,0.5014093246619263
Lao PDR,2009,149500279,284810980,-135310701,-0.9050866119119416
Lao PDR,2010,393300297,409704739,-16404442,-0.04170971170153986
Lao PDR,2011,636345623,409881916,226463707,0.35588161341057895
Lao PDR,2012,715424484,485892500,229531984,0.3208332802879025
Lao PDR,2013,962763352,480487599,482275753,0.5009286570766769
Lao PDR,2014,974083381,508921085,465162296,0.47753847881324235
Lao PDR,2015,968286666,691862470,276424196,0.2854776438695687
Lao PDR,2016,1187606010,818069447,369536563,0.3111609068061217
Lao PDR,2017,1151501725,887756908,263744817,0.22904422223075696
Lao PDR,2018,1325024724,936720868,388303856,0.2930540456843581
Lao PDR,2019,1439651747,1119351194,320300553,0.22248474581957353
Lao PDR,2020,1562415222,1472725696,89689526,0.05740441128395509
Latvia,1995,46912380,75100142,-28187762,-0.6008597730492463
Latvia,1996,30320874,77095250,-46774376,-1.542646033224504
Latvia,1997,45056372,76562056,-31505684,-0.6992503524251797
Latvia,1998,68337247,76434281,-8097034,-0.11848639439630923
Latvia,1999,43560829,75913828,-32352999,-0.742708523751924
Latvia,2000,40516036,75813325,-35297289,-0.8711930505738518
Latvia,2001,41443525,77408787,-35965262,-0.8678137779061988
Latvia,2002,39944086,78164255,-38220169,-0.9568417462349745
Latvia,2003,46132719,79373982,-33241263,-0.7205572036627627
Latvia,2004,73059424,78828616,-5769192,-0.078965747115663
Latvia,2005,82040191,78292338,3747853,0.04568313352659065
Latvia,2006,70512557,77764999,-7252442,-0.10285319818993374
Latvia,2007,81837034,77246448,4590586,0.056094237237385706
Latvia,2008,104864511,76736540,28127971,0.26823155643189905
Latvia,2009,127358257,76235131,51123126,0.40141194771533345
Latvia,2010,123355245,86971886,36383359,0.29494780704298384
Latvia,2011,126176603,86348713,39827890,0.3156519438076804
Latvia,2012,158586932,85735925,72851007,0.4593758519775135
Latvia,2013,128205431,88345096,39860335,0.3109098786930485
Latvia,2014,88436471,88042872,393599,0.004450641183997493
Latvia,2015,83855026,87417248,-3562222,-0.04248072142986396
Latvia,2016,115262876,86802050,28460826,0.2469210121045392
Latvia,2017,199671159,86252609,113418550,0.5680267023441278
Latvia,2018,114515561,85830577,28684984,0.2504898351761993
Latvia,2019,100634498,90975877,9658621,0.09597723635487306
Latvia,2020,121982670,90327291,31655379,0.259507182454688
Lebanon,1995,29332212,11272016,18060196,0.6157120369919595
Lebanon,1996,33285695,16299685,16986010,0.5103096089776704
Lebanon,1997,37243623,16607663,20635960,0.5540803589382268
Lebanon,1998,33841334,16917359,16923975,0.500097750283721
Lebanon,1999,13946259,16724158,-2777899,-0.1991859609089434
Lebanon,2000,17662767,16534177,1128590,0.06389655709096995
Lebanon,2001,12713906,16399662,-3685756,-0.28989957924810833
Lebanon,2002,26648276,16215239,10433037,0.39150889160709684
Lebanon,2003,57419159,16088038,41331121,0.7198141129165615
Lebanon,2004,52584898,15908963,36675935,0.6974613699925785
Lebanon,2005,50745103,15732872,35012231,0.6899627536473815
Lebanon,2006,35969886,15648387,20321499,0.5649586712618438
Lebanon,2007,32564205,15476893,17087312,0.5247268281230879
Lebanon,2008,23051364,15308257,7743107,0.33590667346192615
Lebanon,2009,36877392,15142432,21734960,0.5893844119996338
Lebanon,2010,48023028,14979370,33043658,0.688079435557458
Lebanon,2011,47636701,14822900,32813801,0.6888344556017848
Lebanon,2012,60412903,14665176,45747727,0.757250930318644
Lebanon,2013,65307122,14510079,50797043,0.7778178159496908
Lebanon,2014,11586832,14357568,-2770736,-0.23912800323677774
Lebanon,2015,25947300,14207599,11739701,0.45244403078547674
Lebanon,2016,20611907,14679731,5932176,0.28780335560411757
Lebanon,2017,21704552,14723525,6981027,0.32163884331729126
Lebanon,2018,18530098,14569791,3960307,0.21372293875617926
Lebanon,2019,52612422,14418619,38193803,0.7259464884547607
Lebanon,2020,58491956,14269966,44221990,0.7560354110913986
Lesotho,2000,37635378,5274956,32360422,0.8598404936971803
Lesotho,2001,37671267,5221909,32449358,0.8613821775625439
Lesotho,2002,40662296,5169745,35492551,0.8728614586839858
Lesotho,2003,51277940,5118450,46159490,0.9001822226087866
Lesotho,2004,53576319,5068011,48508308,0.9054057633186782
Lesotho,2005,63009076,5018412,57990664,0.9203541407272819
Lesotho,2006,70469449,4969640,65499809,0.9294780919884871
Lesotho,2007,83846020,4921681,78924339,0.9413009585905211
Lesotho,2008,96283287,4874521,91408766,0.9493731347165163
Lesotho,2009,93517405,4828147,88689258,0.9483716747700602
Lesotho,2010,91328698,4782546,86546152,0.9476336999789485
Lesotho,2011,93425452,6085975,87339477,0.934857419796053
Lesotho,2012,91080158,6366659,84713499,0.9300982877082844
Lesotho,2013,95437192,6300250,89136942,0.9339853796201381
Lesotho,2014,98103549,6234947,91868602,0.9364452452173774
Lesotho,2015,85060171,6170732,78889439,0.9274545074686013
Lesotho,2016,79032417,6107588,72924829,0.9227204705127517
Lesotho,2017,78636327,6045496,72590831,0.9231208242979101
Lesotho,2018,83609638,5984440,77625198,0.9284240412570618
Lesotho,2019,69408344,5924400,63483944,0.914644268130068
Lesotho,2020,66022539,5865362,60157177,0.911161217232194
Liberia,2016,1076397,5901628,-4825231,-4.482761471836135
Liberia,2017,11748787,26678213,-14929426,-1.2707206284359398
Liberia,2018,12276443,26310032,-14033589,-1.1431315243348583
Liberia,2019,12680345,25947988,-13267643,-1.046315616806956
Liberia,2020,12613748,25591978,-12978230,-1.0288956145310657
Lithuania,1995,6001657,4582567,1419090,0.23644970047438565
Lithuania,1996,7012236,4552830,2459406,0.35073063713200753
Lithuania,1997,5714077,5111902,602175,0.10538447416791899
Lithuania,1998,6799987,5075900,1724087,0.25354269059632023
Lithuania,1999,6447956,5442581,1005375,0.1559215044271394
Lithuania,2000,5301642,6019732,-718090,-0.13544671631920827
Lithuania,2001,5104787,5973030,-868243,-0.1700840799038236
Lithuania,2002,6061150,5927106,134044,0.022115275154054925
Lithuania,2003,6893907,7188829,-294922,-0.04278009552493238
Lithuania,2004,10169711,7351955,2817756,0.2770733602950959
Lithuania,2005,11284213,8903977,2380236,0.21093504704315666
Lithuania,2006,10381966,8822878,1559088,0.1501727129524408
Lithuania,2007,12445069,8743129,3701940,0.2974623925347461
Lithuania,2008,13207305,8664710,4542595,0.343945642203311
Lithuania,2009,14319156,8838054,5481102,0.3827810801139397
Lithuania,2010,21664257,8759142,12905115,0.5956869418600417
Lithuania,2011,21097152,8681545,12415607,0.5884968264910828
Lithuania,2012,17533713,8605242,8928471,0.5092173574416325
Lithuania,2013,24269799,8530210,15739589,0.6485257253263613
Lithuania,2014,17823654,8759064,9064590,0.5085708014753877
Lithuania,2015,12298932,8682784,3616148,0.29402130201223975
Lithuania,2016,15320962,8607776,6713186,0.43817000525162847
Lithuania,2017,19173968,8534017,10639951,0.5549164888561408
Lithuania,2018,14169593,8461488,5708105,0.40284184591611066
Lithuania,2019,12339775,8390168,3949607,0.3200712330654327
Lithuania,2020,11672024,8320037,3351987,0.28718129777663237
Madagascar,1995,30323010,10778522,19544488,0.6445431373732357
Madagascar,1996,33837956,10646329,23191627,0.6853731649748585
Madagascar,1997,37530284,10516338,27013946,0.7197906096314113
Madagascar,1998,41222934,10388514,30834420,0.7479918823827533
Madagascar,1999,32965277,10262820,22702457,0.6886778776347003
Madagascar,2000,32024467,10139222,21885245,0.6833913894648114
Madagascar,2001,35471479,10017683,25453796,0.7175848517621721
Madagascar,2002,34201784,9898170,24303614,0.710594921013477
Madagascar,2003,40497303,9780649,30716654,0.75848641081111
Madagascar,2004,45905845,9665086,36240759,0.789458488347181
Madagascar,2005,50072427,9551450,40520977,0.8092473128973756
Madagascar,2006,52895615,9439707,43455908,0.8215408403891324
Madagascar,2007,62675608,9357533,53318075,0.8506989672920285
Madagascar,2008,69076731,18949468,50127263,0.7256750902123611
Madagascar,2009,72459514,18708886,53750628,0.7418022152342894
Madagascar,2010,68184149,18472314,49711835,0.7290819894224976
Madagascar,2011,70282723,18410410,51872313,0.7380521241329822
Madagascar,2012,78342828,29511386,48831442,0.6233045608208068
Madagascar,2013,85607354,29127638,56479716,0.6597530861659385
Madagascar,2014,93432068,28928271,64503797,0.6903817755591153
Madagascar,2015,94540067,28734452,65805615,0.6960605919604436
Madagascar,2016,89399138,28364675,61034463,0.682718696907346
Madagascar,2017,79765465,29359405,50406060,0.6319283664929428
Madagascar,2018,104735367,28983092,75752275,0.7232731136560585
Madagascar,2019,99017296,28613051,70404245,0.7110297679710421
Madagascar,2020,90897670,28249178,62648492,0.6892199987084378
Malawi,1995,13570147,12250260,1319887,0.0972640163735883
Malawi,1996,15857196,21287807,-5430611,-0.34246981622728256
Malawi,1997,18644273,21736265,-3091992,-0.16584138196217144
Malawi,1998,44912831,21479169,23433662,0.5217587374975317
Malawi,1999,17350868,21226359,-3875491,-0.22336006475295644
Malawi,2000,20852001,32799591,-11947590,-0.5729709105615332
Malawi,2001,31817233,32391884,-574651,-0.018060998578977625
Malawi,2002,31158613,32275977,-1117364,-0.03586051792485115
Malawi,2003,26567447,31877810,-5310363,-0.1998823221516166
Malawi,2004,31912394,31486280,426114,0.01335261779482918
Malawi,2005,31202968,31101275,101693,0.003259080995115593
Malawi,2006,36543141,30722687,5820454,0.15927623736558388
Malawi,2007,35408259,30350409,5057850,0.1428437924609623
Malawi,2008,40390705,29984336,10406369,0.25764266803463814
Malawi,2009,46378157,29624363,16753794,0.3612432033467824
Malawi,2010,62148678,29270391,32878287,0.5290263294096135
Malawi,2011,81190987,28922317,52268670,0.6437742898728402
Malawi,2012,77037556,28580045,48457511,0.6290115304280941
Malawi,2013,90251415,39566346,50685069,0.5615986076229387
Malawi,2014,79052906,50505716,28547190,0.3611149981001331
Malawi,2015,105853527,49958571,55894956,0.5280405630697595
Malawi,2016,106186695,49407100,56779595,0.5347147775905446
Malawi,2017,104512395,48788888,55723507,0.533176060121864
Malawi,2018,79639522,48180980,31458542,0.39501168778988904
Malawi,2019,114537593,47583203,66954390,0.5845625723948992
Malawi,2020,111875189,50685089,61190100,0.5469496905162771
Malaysia,1995,391218840,98166479,293052361,0.7490752771517855
Malaysia,1996,331807856,111581504,220226352,0.66371650947288
Malaysia,1997,318780169,125058604,193721565,0.6076964122570623
Malaysia,1998,209911025,145050102,64860923,0.30899245525574465
Malaysia,1999,343621654,143353420,200268234,0.5828161050642053
Malaysia,2000,336396344,146329659,190066685,0.5650081767832769
Malaysia,2001,298387360,144622979,153764381,0.5153180114600029
Malaysia,2002,261490835,145070352,116420483,0.4452182157741781
Malaysia,2003,270421458,143389845,127031613,0.4697541901427068
Malaysia,2004,293272521,144144685,149127836,0.5084957686847177
Malaysia,2005,329844011,142485477,187358534,0.5680216337170361
Malaysia,2006,361784867,145362436,216422431,0.5982075281219543
Malaysia,2007,390627395,150292401,240334994,0.6152538123958254
Malaysia,2008,475928602,149324442,326604160,0.6862461273130208
Malaysia,2009,414997477,148201460,266796017,0.6428858771110071
Malaysia,2010,433215529,147779866,285435663,0.658876803559828
Malaysia,2011,573293030,319134940,254158090,0.44333015874970605
Malaysia,2012,685785420,374059423,311725997,0.4545532580730573
Malaysia,2013,828361394,531312187,297049207,0.35859856477087343
Malaysia,2014,1062356357,627946665,434409692,0.40891146284165364
Malaysia,2015,985344867,808179529,177165338,0.17980033583510818
Malaysia,2016,1292950602,886324385,406626217,0.3144947814487347
Malaysia,2017,1629451091,876465437,752985654,0.4621100063444617
Malaysia,2018,1753262412,873715992,879546420,0.5016627368385058
Malaysia,2019,1712783601,877067380,835716221,0.48792866799522794
Malaysia,2020,2158973137,871768424,1287204713,0.5962115465635829
Mali,1995,16608819,3574708,13034111,0.7847704884977071
Mali,1996,16213983,3537807,12676176,0.7818051863012315
Mali,1997,17585691,3501522,14084169,0.8008880060499186
Mali,1998,18486497,3465841,15020656,0.812520403405794
Mali,1999,14647697,3891321,10756376,0.7343390568496877
Mali,2000,14100373,3850460,10249913,0.7269249543965964
Mali,2001,22700884,12556804,10144080,0.4468583690397255
Mali,2002,40619545,34243378,6376167,0.15697288091237852
Mali,2003,56815659,47839966,8975693,0.1579792113297498
Mali,2004,59939256,47194197,12745059,0.21263291956777042
Mali,2005,64628556,46559190,18069366,0.27958795799182024
Mali,2006,69284513,45934767,23349746,0.33701248647010046
Mali,2007,74809332,45320751,29488581,0.3941831882685438
Mali,2008,86852678,44716968,42135710,0.4851400206681019
Mali,2009,84788232,60160274,24627958,0.29046434179686637
Mali,2010,85515790,60378680,25137110,0.2939470008988983
Mali,2011,94588517,61426550,33161967,0.35059189055686324
Mali,2012,107794533,60900266,46894267,0.4350338156759768
Mali,2013,135518274,73813496,61704778,0.45532440886902087
Mali,2014,140004183,73127931,66876252,0.4776732420916309
Mali,2015,130561371,72155631,58405740,0.44734318851477134
Mali,2016,140821528,71199535,69621993,0.49439878965096873
Mali,2017,146583975,70259375,76324600,0.520688567764655
Mali,2018,160566469,69334884,91231585,0.5681857835461276
Mali,2019,171345091,68425801,102919290,0.6006550254772108
Mali,2020,174832441,68146819,106685622,0.610216395708849
Mauritius,1995,13572556,4344285,9228271,0.6799213795839192
Mauritius,1996,10203378,4298934,5904444,0.5786754151419266
Mauritius,1997,7739667,4254338,3485329,0.4503202786373109
Mauritius,1998,7722139,4210486,3511653,0.45475133249997185
Mauritius,1999,2033697,4167364,-2133667,-1.0491567819591612
Mauritius,2000,6814615,4124962,2689653,0.39468891492769587
Mauritius,2001,5434997,4083266,1351731,0.24870869293948092
Mauritius,2002,8055360,4042265,4013095,0.49818940432209113
Mauritius,2003,12274883,4001947,8272936,0.6739726969291683
Mauritius,2004,13186452,3962301,9224151,0.6995172772782247
Mauritius,2005,11938043,3923316,8014727,0.6713602053535911
Mauritius,2006,8167537,3884981,4282556,0.524338732717097
Mauritius,2007,9448122,3847285,5600837,0.5927989710547769
Mauritius,2008,16845643,3810217,13035426,0.7738158763070071
Mauritius,2009,17852839,3773766,14079073,0.7886181575938707
Mauritius,2010,15821182,3960825,11860357,0.7496505001965087
Mauritius,2011,10152805,3922501,6230304,0.6136534681794834
Mauritius,2012,12948344,3884817,9063527,0.6999757652407134
Mauritius,2013,16257222,4160537,12096685,0.7440806922609533
Mauritius,2014,15703402,4166054,11537348,0.7347037285296524
Mauritius,2015,18467357,4125336,14342021,0.7766147045297278
Mauritius,2016,14835184,4085297,10749887,0.724621076489513
Mauritius,2017,13824676,4045925,9778751,0.7073403383920173
Mauritius,2018,19610672,4007209,15603463,0.7956618212777207
Mauritius,2019,15043862,3969138,11074724,0.7361622966230347
Mauritius,2020,15907373,3956300,11951073,0.751291429452242
Mexico,1995,683828502,675220549,8607953,0.012587882743735066
Mexico,1996,842614263,781388071,61226192,0.07266218326522679
Mexico,1997,798607627,774992128,23615499,0.029570840800397215
Mexico,1998,750690859,768702783,-18011924,-0.023993796892630072
Mexico,1999,1077248387,762518262,314730125,0.2921611476035564
Mexico,2000,1253050403,756436815,496613588,0.39632371276608575
Mexico,2001,1185612088,750456726,435155362,0.36703013270897084
Mexico,2002,1274599024,744576305,530022719,0.41583486964917055
Mexico,2003,1002086651,740394512,261692139,0.2611472159007934
Mexico,2004,1257404329,901764630,355639699,0.2828363882625061
Mexico,2005,1491794203,898803177,592991026,0.3975018972506357
Mexico,2006,1700822772,930423241,770399531,0.4529569709923898
Mexico,2007,1410009171,1077407279,332601892,0.23588633240173443
Mexico,2008,2092628088,1067675693,1024952395,0.48979195150705634
Mexico,2009,1182567121,1066490779,116076342,0.09815623987739805
Mexico,2010,1846202103,1079302856,766899247,0.4153929007847089
Mexico,2011,1914816367,1069673198,845143169,0.44137034943152853
Mexico,2012,1592845248,1070585094,522260154,0.3278787783406816
Mexico,2013,1410828260,1062490466,348337794,0.24690304544934477
Mexico,2014,1944388074,1215784167,728603907,0.3747214441102358
Mexico,2015,1290818046,1204637724,86180322,0.06676411308863898
Mexico,2016,1082732979,1284882099,-202149120,-0.18670265330488284
Mexico,2017,1124916410,1285480096,-160563686,-0.1427338818890552
Mexico,2018,1129973464,1277623343,-147649879,-0.13066667820440073
Mexico,2019,1528807971,1444514170,84293801,0.055136944991765746
Mexico,2020,1583694579,1430800362,152894217,0.09654274190705556
Morocco,1995,36371416,63247031,-26875615,-0.738921327671158
Morocco,1996,117570685,62604732,54965953,0.4675141001347402
Morocco,1997,116807343,88285867,28521476,0.24417536832423284
Morocco,1998,101567174,87301433,14265741,0.14045621669064062
Morocco,1999,46508551,105047420,-58538869,-1.258668948856308
Morocco,2000,44980192,103837095,-58856903,-1.3085071535488333
Morocco,2001,51621430,102646943,-51025513,-0.9884560152634284
Morocco,2002,53127508,114871880,-61744372,-1.1621921359458456
Morocco,2003,105929853,123929028,-17999175,-0.16991598204143643
Morocco,2004,128143441,124441917,3701524,0.028885785890516238
Morocco,2005,78085614,122981945,-44896331,-0.5749628990559004
Morocco,2006,82803915,121546307,-38742392,-0.4678811623822376
Morocco,2007,81582159,120134595,-38552436,-0.47255964383095084
Morocco,2008,87602383,118746412,-31144029,-0.3555157740400738
Morocco,2009,236261040,124066942,112194098,0.474873461997797
Morocco,2010,305363925,129436584,175927341,0.5761235253967868
Morocco,2011,183741959,127931910,55810049,0.3037414497142702
Morocco,2012,140099990,126452315,13647675,0.09741381851633252
Morocco,2013,245553944,124997379,120556565,0.49095755920743833
Morocco,2014,144370322,123566692,20803630,0.1440990759859911
Morocco,2015,154824318,122159850,32664468,0.2109776320797357
Morocco,2016,106209360,120776455,-14567095,-0.1371545313897005
Morocco,2017,104945960,119416117,-14470157,-0.13788198230784682
Morocco,2018,154872656,118078451,36794205,0.23757715500146134
Morocco,2019,112713133,116763080,-4049947,-0.03593145618621035
Morocco,2020,78424014,115469631,-37045617,-0.4723759357688577
Mozambique,1995,27976634,151253808,-123277174,-4.4064333829437805
Mozambique,1996,34339993,149709076,-115369083,-3.3596128863509085
Mozambique,1997,75027163,148190089,-73162926,-0.9751525057664782
Mozambique,1998,551930919,146696419,405234500,0.7342123552965873
Mozambique,1999,491433464,145227643,346205821,0.7044815755566861
Mozambique,2000,525699987,143783346,381916641,0.7264916310526749
Mozambique,2001,746669941,142363122,604306819,0.809335940577257
Mozambique,2002,811897656,140966567,670931089,0.8263739697260563
Mozambique,2003,721694221,139593289,582100932,0.80657557600146
Mozambique,2004,842499219,138242899,704256320,0.8359133208881943
Mozambique,2005,1027974617,136915015,891059602,0.866810899086626
Mozambique,2006,1223912880,135609262,1088303618,0.8892002329446848
Mozambique,2007,1403966930,148178367,1255788563,0.8944573665990836
Mozambique,2008,1497224277,146724472,1350499805,0.9020023424319615
Mozambique,2009,1681046812,145294809,1535752003,0.9135688500981495
Mozambique,2010,1618533760,152144570,1466389190,0.9059985193018155
Mozambique,2011,1730158518,150816693,1579341825,0.9128307080357362
Mozambique,2012,1636902373,152605162,1484297211,0.9067719831572386
Mozambique,2013,1671322998,159847658,1511475340,0.9043586080061826
Mozambique,2014,1835750309,164487132,1671263177,0.9103978731782961
Mozambique,2015,1756797329,162837575,1593959754,0.9073099825961769
Mozambique,2016,1598389140,161215510,1437173630,0.899138760414751
Mozambique,2017,1455210774,177230862,1277979912,0.8782094902219298
Mozambique,2018,1503397159,175419225,1327977934,0.8833181079597876
Mozambique,2019,1667953500,173637782,1494315718,0.8958977081795146
Mozambique,2020,1745180423,171886030,1573294393,0.9015081605691379
Namibia,1995,70046286,25043735,45002551,0.6424687670092887
Namibia,1996,49429752,24757543,24672209,0.4991368154143278
Namibia,1997,32537920,24476121,8061799,0.2477662677884757
Namibia,1998,47381765,24199389,23182376,0.4892678860738936
Namibia,1999,53548888,27266607,26282281,0.490809090190631
Namibia,2000,62217370,26952908,35264462,0.5667944819911224
Namibia,2001,58726715,26644437,32082278,0.5462978475809519
Namibia,2002,72918649,26341107,46577542,0.6387603533356742
Namibia,2003,89449188,27932459,61516729,0.6877281993884617
Namibia,2004,99958710,27613061,72345649,0.7237553285751687
Namibia,2005,107194179,27298987,79895192,0.7453314419246589
Namibia,2006,99687999,26990147,72697852,0.7292537991458731
Namibia,2007,107458208,26686455,80771753,0.7516573605992015
Namibia,2008,107285114,26387824,80897290,0.7540402110212606
Namibia,2009,103280122,26094170,77185952,0.7473456702539526
Namibia,2010,119174525,25805411,93369114,0.7834653756748768
Namibia,2011,169246902,25521464,143725438,0.8492057243092107
Namibia,2012,161113720,42275333,118838387,0.7376056303584821
Namibia,2013,158033687,41765553,116268134,0.7357174043531617
Namibia,2014,153236315,41264270,111972045,0.7307148113030517
Namibia,2015,138108723,41669855,96438868,0.698282236669439
Namibia,2016,129768214,46883988,82884226,0.6387097690964599
Namibia,2017,143121464,46316282,96805182,0.6763847943869551
Namibia,2018,109645574,45758039,63887535,0.5826731774873102
Namibia,2019,107627816,45209099,62418717,0.5799496758347303
Namibia,2020,127882382,45489242,82393140,0.6442884368544214
Nepal,1995,73692231,12039993,61652238,0.8366178790271663
Nepal,1996,88258645,12853324,75405321,0.8543675353275592
Nepal,1997,89309297,12704458,76604839,0.8577476430029451
Nepal,1998,77921225,20796212,57125013,0.7331123580256855
Nepal,1999,96232595,35322949,60909646,0.6329419465410862
Nepal,2000,105253784,43400222,61853562,0.5876611714026357
Nepal,2001,115937951,52337497,63600454,0.5485732105098183
Nepal,2002,138121174,52156107,85965067,0.6223887656790407
Nepal,2003,160728652,65478918,95249734,0.592612037833802
Nepal,2004,178458551,65775903,112682648,0.6314219597132109
Nepal,2005,182859808,65605054,117254754,0.6412275900453751
Nepal,2006,196918436,65393630,131524806,0.6679151463502381
Nepal,2007,223843830,65552967,158290863,0.7071486535947853
Nepal,2008,215622558,65987733,149634825,0.6939664680167648
Nepal,2009,201991794,76828100,125163694,0.619647419934297
Nepal,2010,219083727,76659419,142424308,0.6500907664401747
Nepal,2011,238418406,88547133,149871273,0.6286061362225532
Nepal,2012,218588471,87511313,131077158,0.5996526596318065
Nepal,2013,224967768,90870601,134097167,0.5960727983041553
Nepal,2014,230389696,97660347,132729349,0.5761080087540026
Nepal,2015,204535376,97751982,106783394,0.5220778727294588
Nepal,2016,243799439,118707210,125092229,0.5130948188933281
Nepal,2017,320485021,147275489,173209532,0.5404606164105249
Nepal,2018,326673086,164786009,161887077,0.49556294637630477
Nepal,2019,387424062,176716650,210707412,0.5438676444417642
Nepal,2020,395039807,206647165,188392642,0.47689533728432587
New Zealand,1995,1195311155,526643516,668667639,0.5594088503256711
New Zealand,1996,1265575881,522256123,743319758,0.5873371712904822
New Zealand,1997,1143242983,524713418,618529565,0.5410307119287169
New Zealand,1998,991064742,520567797,470496945,0.4747388591894837
New Zealand,1999,892753825,564348779,328405046,0.3678562183701649
New Zealand,2000,816113629,559572046,256541583,0.31434542186771885
New Zealand,2001,721047069,569454727,151592342,0.21023917649403828
New Zealand,2002,963728617,587406719,376321898,0.39048534137281926
New Zealand,2003,1219696386,582803843,636892543,0.5221730180645137
New Zealand,2004,1755083530,578086764,1176996766,0.670621509393345
New Zealand,2005,1696090675,573455528,1122635147,0.6618957132112055
New Zealand,2006,1689307054,568692837,1120614217,0.6633573300641649
New Zealand,2007,2019632409,564009524,1455622885,0.7207365451818712
New Zealand,2008,1918721704,564604517,1354117187,0.705739234708735
New Zealand,2009,1925904909,560011953,1365892956,0.7092213897046565
New Zealand,2010,2402285515,555495930,1846789585,0.7687635684720016
New Zealand,2011,2828637035,570727498,2257909537,0.7982323320602355
New Zealand,2012,2744131168,569404976,2174726192,0.7925008167831138
New Zealand,2013,2889024986,568176925,2320848061,0.803332637220743
New Zealand,2014,3171565551,563639184,2607926367,0.822283608856111
New Zealand,2015,2679094596,559177071,2119917525,0.7912813262230924
New Zealand,2016,2858659009,554789327,2303869682,0.8059267211467543
New Zealand,2017,2865928409,550474712,2315453697,0.8079244721287104
New Zealand,2018,2925886031,546232008,2379654023,0.8133105656841628
New Zealand,2019,2721068636,544254701,2176813935,0.7999849420189341
New Zealand,2020,2556394589,540125206,2016269383,0.7887160267338525
Nicaragua,1995,14347254,15719754,-1372500,-0.09566290525002207
Nicaragua,1996,15429469,15527297,-97828,-0.006340334848853191
Nicaragua,1997,15483057,15338047,145010,0.009365721510939345
Nicaragua,1998,13293972,15151952,-1857980,-0.13976108870998075
Nicaragua,1999,19237760,14968958,4268802,0.22189703998802354
Nicaragua,2000,10236130,16120470,-5884340,-0.5748598347226931
Nicaragua,2001,9659433,15925138,-6265705,-0.6486617796303364
Nicaragua,2002,14478387,15733062,-1254675,-0.08665847929054528
Nicaragua,2003,14125002,15544187,-1419185,-0.10047326010998087
Nicaragua,2004,15657029,15503383,153646,0.00981322829509992
Nicaragua,2005,22075053,15318750,6756303,0.30606055623060113
Nicaragua,2006,16290470,15137195,1153275,0.07079445835509963
Nicaragua,2007,17153100,15207141,1945959,0.11344649072179373
Nicaragua,2008,29841485,15028156,14813329,0.4964005310057459
Nicaragua,2009,16577339,14852153,1725186,0.1040689341033564
Nicaragua,2010,28138017,14679084,13458933,0.4783184614608769
Nicaragua,2011,24818254,14508900,10309354,0.41539400797493653
Nicaragua,2012,23400328,14403711,8996617,0.38446542287783314
Nicaragua,2013,25482697,18792979,6689718,0.262520015051782
Nicaragua,2014,22106545,18567420,3539125,0.16009399026396934
Nicaragua,2015,15410776,24038178,-8627402,-0.5598291740792287
Nicaragua,2016,20886904,25729653,-4842749,-0.23185575995370114
Nicaragua,2017,22933089,25410428,-2477339,-0.10802465380917503
Nicaragua,2018,20319649,25096524,-4776875,-0.23508649189757166
Nicaragua,2019,12068521,31049550,-18981029,-1.5727717588592671
Nicaragua,2020,31473233,30659551,813682,0.025853143209024633
Nigeria,1995,687929058,164125779,523803279,0.7614204879247883
Nigeria,1996,680804734,162392412,518412322,0.7614699136331211
Nigeria,1997,648449741,160687935,487761806,0.75219677819256
Nigeria,1998,677432555,159011866,518420689,0.7652727716931171
Nigeria,1999,693738295,157363731,536374564,0.7731655695898985
Nigeria,2000,615631854,155743065,459888789,0.7470191576539182
Nigeria,2001,613526457,154149410,459377047,0.7487485531532668
Nigeria,2002,767617176,152582316,615034860,0.801226026761027
Nigeria,2003,932528969,151041341,781487628,0.8380304033214436
Nigeria,2004,1075449701,149526048,925923653,0.8609641642366312
Nigeria,2005,1437606862,148036010,1289570852,0.8970260827817335
Nigeria,2006,1234570528,146570807,1087999721,0.88127789893264
Nigeria,2007,1158582402,145130023,1013452379,0.8747348287446196
Nigeria,2008,1260490082,143713252,1116776830,0.885986209608272
Nigeria,2009,1108848569,142320094,966528475,0.8716505589862921
Nigeria,2010,1239039471,154449903,1084589568,0.8753470679385645
Nigeria,2011,1084886527,163028404,921858123,0.8497276904610319
Nigeria,2012,1020806192,161380789,859425403,0.8419084932431523
Nigeria,2013,1105886307,159760635,946125672,0.8555361125381942
Nigeria,2014,1107382321,158167483,949214838,0.8571699403172972
Nigeria,2015,1042463269,156780586,885682683,0.8496056497507156
Nigeria,2016,1253796101,155237615,1098558486,0.8761859166126088
Nigeria,2017,1198116443,153720360,1044396083,0.8716983137172419
Nigeria,2018,1244136270,152228393,1091907877,0.8776433123358746
Nigeria,2019,1308413220,150761292,1157651928,0.8847754748304973
Nigeria,2020,1246788521,149318642,1097469879,0.8802373943255128
North Macedonia,1995,38686522,30010756,8675766,0.22425810208526886
North Macedonia,1996,39856952,29726550,10130402,0.2541690092107394
North Macedonia,1997,34179569,29447081,4732488,0.13845955752104422
North Macedonia,1998,37968106,29172270,8795836,0.2316638075125475
North Macedonia,1999,46011484,28902039,17109445,0.3718516229556951
North Macedonia,2000,35674067,28636312,7037755,0.19727930095550922
North Macedonia,2001,19449889,28375014,-8925125,-0.4588779401260336
North Macedonia,2002,25443399,28118070,-2674671,-0.10512239343493375
North Macedonia,2003,55174090,30696985,24477105,0.4436340499680194
North Macedonia,2004,65133720,44100768,21032952,0.32291955687468793
North Macedonia,2005,66082028,43653549,22428479,0.33940361212885295
North Macedonia,2006,76169519,43332676,32836843,0.43110214467810937
North Macedonia,2007,52022145,42898776,9123369,0.1753747178244957
North Macedonia,2008,50076910,44089414,5987496,0.11956600357330355
North Macedonia,2009,71352482,43775161,27577321,0.38649420772777043
North Macedonia,2010,131525191,43902952,87622239,0.6662011918310007
North Macedonia,2011,84662564,43756128,40906436,0.4831702947243601
North Macedonia,2012,58669009,54712256,3956753,0.06744196071217089
North Macedonia,2013,94634170,60685854,33948316,0.3587321154716103
North Macedonia,2014,72156850,63986177,8170673,0.1132348903811627
North Macedonia,2015,96146800,71869872,24276928,0.25249855429405865
North Macedonia,2016,96628182,71741605,24886577,0.25754988332492895
North Macedonia,2017,57106855,73588377,-16481522,-0.2886084691583874
North Macedonia,2018,93095768,73665913,19429855,0.20870825191538245
North Macedonia,2019,57346794,73951983,-16605189,-0.2895574075161028
North Macedonia,2020,65648754,75152304,-9503550,-0.14476360053992798
Norway,1995,2388891098,1566030835,822860263,0.34445281481809936
Norway,1996,2108318247,1567092705,541225542,0.25670960386086344
Norway,1997,2143700569,1554812256,588888313,0.27470642193032885
Norway,1998,1936728090,1542736482,393991608,0.20343155553653378
Norway,1999,1915726116,1559878697,355847419,0.18575067491536978
Norway,2000,2048559352,1578902413,469656939,0.2292620609412541
Norway,2001,2188633774,1566686329,621947445,0.28417154682910417
Norway,2002,2609711645,1585104096,1024607549,0.3926133183959487
Norway,2003,3262182033,1582998164,1679183869,0.5147425410395545
Norway,2004,3176569265,1580058817,1596510448,0.5025895281398814
Norway,2005,4137878485,1640928247,2496950238,0.6034373041769012
Norway,2006,4650691310,1653697909,2996993401,0.6444189048960981
Norway,2007,4397251997,1675383984,2721868013,0.6189929562501715
Norway,2008,5265305372,1731450422,3533854950,0.6711585939141234
Norway,2009,4154461315,1737004377,2417456938,0.5818941987187574
Norway,2010,5131816180,1750425030,3381391150,0.658907301313353
Norway,2011,5127506442,1786210291,3341296151,0.6516415315700154
Norway,2012,4815875312,1870844971,2945030341,0.6115254549181733
Norway,2013,4758718159,1953267259,2805450900,0.5895392007392047
Norway,2014,4304871859,1976434731,2328437128,0.5408841898817597
Norway,2015,3244509966,1985404273,1259105693,0.38807268468720124
Norway,2016,3729812824,2034013416,1695799408,0.45466072642791683
Norway,2017,4013671311,2031274297,1982397014,0.49391115026459126
Norway,2018,4723972075,2108675580,2615296495,0.553622344391187
Norway,2019,3943969443,2132434960,1811534483,0.4593175756509024
Norway,2020,2908759798,2261522820,647236978,0.22251303749626425
Pakistan,1995,1242723719,288706642,954017077,0.7676823596540688
Pakistan,1996,1221308281,285566151,935742130,0.766180123853594
Pakistan,1997,1072937479,282478001,790459478,0.7367246400384155
Pakistan,1998,1100138108,280203257,819934851,0.7453017444242555
Pakistan,1999,1061008013,277206347,783801666,0.7387330316043522
Pakistan,2000,854776588,274259386,580517202,0.6791449486915522
Pakistan,2001,718874904,282008003,436866901,0.6077092113929186
Pakistan,2002,937675535,297152052,640523483,0.6830971472450755
Pakistan,2003,1202004176,460600407,741403769,0.6168063171520961
Pakistan,2004,1289841307,528803982,761037325,0.5900239982002685
Pakistan,2005,1558380082,522473299,1035906783,0.6647330744054004
Pakistan,2006,1779414958,516095463,1263319495,0.7099634007909694
Pakistan,2007,1769744544,512058145,1257686399,0.7106598538551562
Pakistan,2008,1749191153,517441214,1231749939,0.7041825799812972
Pakistan,2009,1719641195,511180945,1208460250,0.7027397654311253
Pakistan,2010,2048357115,526294859,1522062256,0.743064890811288
Pakistan,2011,2144580857,519938906,1624641951,0.7575568651082107
Pakistan,2012,2187151937,537400458,1649751479,0.7542921235105762
Pakistan,2013,2246980283,565492337,1681487946,0.748332310132692
Pakistan,2014,2551175075,586799833,1964375242,0.7699884109286385
Pakistan,2015,2693749959,592398166,2101351793,0.7800842041701911
Pakistan,2016,2717430773,589588608,2127842165,0.7830345435629613
Pakistan,2017,2555858153,599664044,1956194109,0.7653766335599924
Pakistan,2018,1979309392,901073395,1078235997,0.5447536405162473
Pakistan,2019,2120725178,1185824314,934900864,0.440840177547984
Pakistan,2020,2706219987,1196749999,1509469988,0.5577780059459742
Panama,1995,146014516,60363356,85651160,0.5865934589681481
Panama,1996,181300362,59750597,121549765,0.6704331070226986
Panama,1997,174105364,59148051,114957313,0.660274389937808
Panama,1998,123671848,58555547,65116301,0.5265248482419378
Panama,1999,200532235,57972919,142559316,0.7109047380836303
Panama,2000,240289682,57400000,182889682,0.7611216614785815
Panama,2001,167033213,67607022,99426191,0.5952480301028514
Panama,2002,179091087,88549207,90541880,0.5055632947272245
Panama,2003,145738097,124233689,21504408,0.14755515848405787
Panama,2004,216840909,124594342,92246567,0.4254112723720412
Panama,2005,262770897,123113724,139657173,0.5314788456196502
Panama,2006,279876363,130217782,149658581,0.5347310483665246
Panama,2007,336472264,128667898,207804366,0.6175973125677902
Panama,2008,467522585,142865133,324657452,0.6944208951958973
Panama,2009,439566462,144372784,295193678,0.6715564164219607
Panama,2010,514026516,159550073,354476443,0.6896073100633586
Panama,2011,527983977,282284673,245699304,0.4653537128078415
Panama,2012,666702829,314410140,352292689,0.5284103706720584
Panama,2013,648445312,318337684,330107628,0.5090755101333819
Panama,2014,548702793,355329704,193373089,0.3524186343990416
Panama,2015,639762070,383367170,256394900,0.400766022280752
Panama,2016,686124136,395457359,290666777,0.4236358433541536
Panama,2017,880324309,393781012,486543297,0.5526864270653692
Panama,2018,929652368,393518332,536134036,0.576703781385947
Panama,2019,567868178,390444084,177424094,0.3124388737979257
Panama,2020,746810686,391686406,355124280,0.4755211550360703
Papua New Guinea,1995,51256969,13809478,37447491,0.7305834061315643
Papua New Guinea,1996,56339641,13712176,42627465,0.756615843540785
Papua New Guinea,1997,38007322,15970978,22036344,0.5797920726958874
Papua New Guinea,1998,35781100,17528194,18252906,0.5101270223665566
Papua New Guinea,1999,41621759,17670427,23951332,0.5754521811536125
Papua New Guinea,2000,31818057,17672785,14145272,0.4445674354031109
Papua New Guinea,2001,30989416,17626087,13363329,0.43122235669107156
Papua New Guinea,2002,34370530,17484999,16885531,0.4912793314505188
Papua New Guinea,2003,37302470,17346262,19956208,0.5349835547083075
Papua New Guinea,2004,36722650,17209838,19512812,0.5313563155164456
Papua New Guinea,2005,39038292,17075687,21962605,0.5625913398055428
Papua New Guinea,2006,44006482,16943772,27062710,0.6149709945003102
Papua New Guinea,2007,50814637,17701738,33112899,0.6516409632130207
Papua New Guinea,2008,56587930,18467640,38120290,0.6736470127110146
Papua New Guinea,2009,56341791,19230668,37111123,0.658678439952326
Papua New Guinea,2010,62139786,21783577,40356209,0.6494423556592229
Papua New Guinea,2011,70995006,21596725,49398281,0.6957993777759522
Papua New Guinea,2012,76022086,22175939,53846147,0.7082960996360979
Papua New Guinea,2013,79423670,21985865,57437805,0.7231824593348557
Papua New Guinea,2014,75158523,21798959,53359564,0.7099602529443001
Papua New Guinea,2015,67461398,24784066,42677332,0.6326185532057904
Papua New Guinea,2016,60916207,24564301,36351906,0.5967526179034752
Papua New Guinea,2017,61040437,24348198,36692239,0.6011136355396669
Papua New Guinea,2018,56085497,29150008,26935489,0.4802576502085735
Papua New Guinea,2019,67442879,28879278,38563601,0.5717964827687738
Papua New Guinea,2020,61573055,28613061,32959994,0.5352989875197844
Paraguay,1995,1700134434,517743148,1182391286,0.6954692889891788
Paraguay,1996,2260354973,552108670,1708246303,0.7557424932831557
Paraguay,1997,2773409634,594196639,2179212995,0.7857522986451124
Paraguay,1998,2622988647,587707691,2035280956,0.7759396741300497
Paraguay,1999,2368211456,581326892,1786884564,0.7545291445461194
Paraguay,2000,2313794889,579698494,1734096395,0.7494598606142915
Paraguay,2001,2252861725,575844232,1677017493,0.7443943293945393
Paraguay,2002,2223970042,569681231,1654288811,0.7438449168642174
Paraguay,2003,2470221734,566084836,1904136898,0.7708364280791321
Paraguay,2004,2675047693,560091532,2114956161,0.7906237210403262
Paraguay,2005,2567151959,554198115,2012953844,0.7841194740899248
Paraguay,2006,2955079191,548402923,2406676268,0.8144202278334137
Paraguay,2007,3341766105,617015351,2724750754,0.8153624964725052
Paraguay,2008,3952496895,686095307,3266401588,0.8264147132239557
Paraguay,2009,3445878089,756916500,2688961589,0.780341474523941
Paraguay,2010,3528458335,823402402,2705055933,0.7666396131612533
Paraguay,2011,4377109068,813987368,3563121700,0.8140353929147283
Paraguay,2012,4375364403,804729252,3570635151,0.816077204575639
Paraguay,2013,4438117153,795625438,3642491715,0.8207290590645658
Paraguay,2014,3948420397,786673354,3161747043,0.8007625138909442
Paraguay,2015,3415430684,777870471,2637560213,0.7722482044082966
Paraguay,2016,3615141459,769214303,2845927156,0.7872242865946453
Paraguay,2017,3668808610,760702404,2908106206,0.792656830905115
Paraguay,2018,3701503352,752332371,2949170981,0.7967495097381179
Paraguay,2019,2968105316,744101838,2224003478,0.7493007293276247
Paraguay,2020,2478729613,736008480,1742721133,0.7030702840116511
Peru,1995,613958678,204692146,409266532,0.6666027318535597
Peru,1996,612163545,205370883,406792662,0.6645163132018912
Peru,1997,609013733,222838861,386174872,0.6340987913321817
Peru,1998,634126764,220305870,413820894,0.6525838641309895
Peru,1999,569346835,238228875,331117960,0.5815751307373124
Peru,2000,692192170,267468223,424723947,0.6135925331255914
Peru,2001,764261694,284468814,479792880,0.6277861153669178
Peru,2002,689303499,289297223,400006276,0.5803050130752346
Peru,2003,746525108,293960939,452564169,0.606227659525686
Peru,2004,753781816,296163095,457618721,0.6070970555224962
Peru,2005,909985569,322675574,587309995,0.6454058339028451
Peru,2006,1159544862,321152772,838392090,0.723035492179172
Peru,2007,1037348555,322495593,714852962,0.689115494068433
Peru,2008,1083609888,321014632,762595256,0.7037544271652124
Peru,2009,1156327269,327584032,828743237,0.7167030123891336
Peru,2010,1207053961,360637371,846416590,0.7012251459734036
Peru,2011,1420843570,361390807,1059452763,0.7456505313952331
Peru,2012,1535027142,364935197,1170091945,0.762261404365448
Peru,2013,1533398494,377117792,1156280702,0.7540640652279132
Peru,2014,1510596352,397472166,1113124186,0.7368773163831922
Peru,2015,1573806346,507258613,1066547733,0.6776867660438319
Peru,2016,1850187783,755027481,1095160302,0.5919184593383514
Peru,2017,2441248711,747724576,1693524135,0.6937122495422794
Peru,2018,2587188195,767613394,1819574801,0.7033020653528453
Peru,2019,2718070348,783354107,1934716241,0.7117977069370539
Peru,2020,2559205644,780006709,1779198935,0.6952153060350159
Philippines,1995,585131830,148662837,436468993,0.7459327464718506
Philippines,1996,695738773,147164344,548574429,0.7884775871187504
Philippines,1997,560941351,145508525,415432826,0.7405993964598984
Philippines,1998,372372616,144068265,228304351,0.6131072511518946
Philippines,1999,635792661,142464506,493328155,0.7759261552721823
Philippines,2000,587037533,140887477,446150056,0.7600026078741374
Philippines,2001,484485278,173818557,310666721,0.6412304668626071
Philippines,2002,485866245,171803063,314063182,0.6463984383191715
Philippines,2003,532915080,227238213,305676867,0.5735939523422756
Philippines,2004,561786798,283591882,278194916,0.4951966065959421
Philippines,2005,600353123,281124186,319228937,0.5317352817368454
Philippines,2006,817026212,285497063,531529149,0.6505656014375215
Philippines,2007,803128429,290261316,512867113,0.6385866749090013
Philippines,2008,1118676842,286631583,832045259,0.7437762432915367
Philippines,2009,1039978311,283062346,756915965,0.7278189910250926
Philippines,2010,902729777,299200165,603529612,0.6685606561087216
Philippines,2011,1240296308,312212342,928083966,0.7482760047045145
Philippines,2012,1419629641,314933874,1104695767,0.7781577216307222
Philippines,2013,1323679841,310997856,1012681985,0.7650505459348459
Philippines,2014,1131844097,312166236,819677861,0.7241967892685842
Philippines,2015,912870796,319471001,593399795,0.6500370015123148
Philippines,2016,732296623,320803971,411492652,0.5619207286717203
Philippines,2017,900002363,319526335,580476028,0.6449716710354904
Philippines,2018,907061895,332780639,574281256,0.6331224574261275
Philippines,2019,770458799,342611520,427847279,0.5553149364447715
Philippines,2020,628799200,344473994,284325206,0.4521717044169267
Poland,1995,43081058,35355850,7725208,0.17931797311013115
Poland,1996,46126636,37040343,9086293,0.19698581531070247
Poland,1997,42980681,37365806,5614875,0.13063718092321525
Poland,1998,52462442,48932918,3529524,0.06727715800953375
Poland,1999,50355704,49330029,1025675,0.020368596177306943
Poland,2000,34465408,49742406,-15276998,-0.44325597422203733
Poland,2001,46058159,55863008,-9804849,-0.21287974189328757
Poland,2002,47772030,55375933,-7603903,-0.15917060673368916
Poland,2003,39507710,60560127,-21052417,-0.5328685717294168
Poland,2004,53588644,62032066,-8443422,-0.15755991138719613
Poland,2005,66501460,70469358,-3967898,-0.05966632913021759
Poland,2006,67468144,72189174,-4721030,-0.06997420886514975
Poland,2007,88652615,71512811,17139804,0.19333669965629327
Poland,2008,103840311,72589436,31250875,0.3009512847086908
Poland,2009,99411844,72665343,26746501,0.26904742859412206
Poland,2010,130720177,73114864,57605313,0.4406765223397762
Poland,2011,115481865,73585050,41896815,0.36279995131703147
Poland,2012,97044588,74365850,22678738,0.23369400053509423
Poland,2013,119689435,74868696,44820739,0.37447531605442036
Poland,2014,104838400,76903611,27934789,0.2664556975306758
Poland,2015,75039997,78026064,-2986067,-0.03979300532221503
Poland,2016,83073657,79542220,3531437,0.04250970918494656
Poland,2017,104952743,78805069,26147674,0.24913759519367684
Poland,2018,84767874,78394009,6373865,0.07519198841768758
Poland,2019,76278438,79194727,-2916289,-0.03823215415082307
Poland,2020,89737969,79164723,10573246,0.1178235491378237
Portugal,1995,345518356,264876990,80641366,0.23339242213805855
Portugal,1996,589431554,265939115,323492439,0.5488210408905255
Portugal,1997,471328648,264897410,206431238,0.43797727737525516
Portugal,1998,468795596,263692884,205102712,0.4375098950374952
Portugal,1999,248300097,265944328,-17644231,-0.07106010514365607
Portugal,2000,339098146,265810949,73287197,0.21612385046776397
Portugal,2001,412886735,268891792,143994943,0.3487516812570886
Portugal,2002,248191631,271596088,-23404457,-0.09429994438450666
Portugal,2003,614501380,269365290,345136090,0.5616522618712426
Portugal,2004,433037632,300946839,132090793,0.30503305772741707
Portugal,2005,212618224,324495702,-111877478,-0.5261895048093338
Portugal,2006,507672739,330203937,177468802,0.3495732356036553
Portugal,2007,529384029,329247738,200136291,0.37805502250994427
Portugal,2008,375875224,326362214,49513010,0.13172725106244298
Portugal,2009,448033938,331789825,116244113,0.2594538117333424
Portugal,2010,869673078,333109046,536564032,0.6169721077648445
Portugal,2011,709789563,407253936,302535627,0.42623284811529416
Portugal,2012,366236932,435840277,-69603345,-0.19005004388798233
Portugal,2013,960077588,431708208,528369380,0.5503402918723272
Portugal,2014,1139135871,437886282,701249589,0.6155978464486437
Portugal,2015,548167944,520506334,27661610,0.05046192558826461
Portugal,2016,1011170413,630989998,380180415,0.375980556899463
Portugal,2017,375886851,664094449,-288207598,-0.7667403029216364
Portugal,2018,830441015,659826938,170614077,0.2054499644384737
Portugal,2019,534340459,659977722,-125637263,-0.2351258656982963
Portugal,2020,733577545,653247568,80329977,0.10950441101628867
Romania,1995,256007588,352988875,-96981287,-0.3788219238251641
Romania,1996,221141015,357761559,-136620544,-0.6177983039464661
Romania,1997,269401394,361837389,-92435995,-0.34311624608742747
Romania,1998,373229827,360204079,13025748,0.03490007244249533
Romania,1999,305178458,357216163,-52037705,-0.17051565612144223
Romania,2000,256914897,362297946,-105383049,-0.4101866035428845
Romania,2001,260618123,359310001,-98691878,-0.37868386459064474
Romania,2002,301896001,356371856,-54475855,-0.18044576549392582
Romania,2003,286308724,370461555,-84152831,-0.2939233908918542
Romania,2004,405803281,374343926,31459355,0.07752365856302675
Romania,2005,606375560,373565283,232810277,0.383937434747535
Romania,2006,608819487,370503538,238315949,0.3914394234887557
Romania,2007,639588678,379459575,260129103,0.4067131141430243
Romania,2008,677460103,384064929,293395174,0.43308111090344165
Romania,2009,528596066,380913756,147682310,0.2793859423085453
Romania,2010,690104398,384552987,305551411,0.442761141481669
Romania,2011,563541627,384002047,179539580,0.31859151373745814
Romania,2012,424276258,392784406,31491852,0.07422487449203438
Romania,2013,657688765,401123896,256564869,0.3901007325250569
Romania,2014,815694503,398738715,416955788,0.511166602774078
Romania,2015,616600619,417892813,198707806,0.3222633903972776
Romania,2016,633331981,415416162,217915819,0.34407834364517903
Romania,2017,514415703,411990549,102425154,0.19910969552964833
Romania,2018,699052160,411217606,287834554,0.41174975269370456
Romania,2019,606664143,407873255,198790888,0.3276786510192675
Romania,2020,639587697,404584642,235003055,0.3674289797979025
Russian Federation,1995,9825020873,3672191277,6152829596,0.6262408676309791
Russian Federation,1996,3229687299,3627891056,-398203757,-0.12329483325623965
Russian Federation,1997,3348957313,3584329173,-235371860,-0.07028213201951912
Russian Federation,1998,2579972986,3541493320,-961520334,-0.3726862022267701
Russian Federation,1999,1911640166,3523839615,-1612199449,-0.8433592669134156
Russian Federation,2000,2076786606,3482081831,-1405295225,-0.676668089509048
Russian Federation,2001,2578562881,3492995605,-914432724,-0.3546288247372006
Russian Federation,2002,2591440447,3471820208,-880379761,-0.33972602458187995
Russian Federation,2003,2888800937,3493678151,-604877214,-0.20938694883842043
Russian Federation,2004,3851630621,3509116406,342514215,0.08892706718357975
Russian Federation,2005,4342329426,3509745266,832584160,0.1917367565470377
Russian Federation,2006,4973077683,3511689992,1461387691,0.29385981562194713
Russian Federation,2007,5885049334,3602984727,2282064607,0.38777323306632455
Russian Federation,2008,6432557221,3608580790,2823976431,0.43901302918545776
Russian Federation,2009,5944877148,3610881801,2333995347,0.3926061529774778
Russian Federation,2010,6345643242,3587678990,2757964252,0.4346232756587736
Russian Federation,2011,7046961902,3562526635,3484435267,0.4944592173843144
Russian Federation,2012,7033491782,3833009025,3200482757,0.455034690619903
Russian Federation,2013,8113839341,3894726467,4219112874,0.5199896986720481
Russian Federation,2014,7048910239,3971156535,3077753704,0.43662830134670977
Russian Federation,2015,4421912627,3950369499,471543128,0.10663782118189737
Russian Federation,2016,4805537740,3910152411,895385329,0.18632364939038018
Russian Federation,2017,5785745804,3919756568,1865989236,0.32251490114030595
Russian Federation,2018,5799696409,3897634404,1902062005,0.3279588914427262
Russian Federation,2019,5962946741,4097821299,1865125442,0.31278586293179167
Russian Federation,2020,6011567122,4104464359,1907102763,0.3172388703805277
Rwanda,1995,11072546,2176776,8895770,0.8034078160524237
Rwanda,1996,11089752,2155433,8934319,0.805637402892328
Rwanda,1997,10367110,2134445,8232665,0.7941137887029268
Rwanda,1998,10171609,2113808,8057801,0.7921854841254712
Rwanda,1999,8187359,2093514,6093845,0.7442992300691835
Rwanda,2000,6365991,2073558,4292433,0.674275694074968
Rwanda,2001,5620676,2053935,3566741,0.6345750938143383
Rwanda,2002,6284615,2034639,4249976,0.6762508125000497
Rwanda,2003,7807841,2015665,5792176,0.7418409263200928
Rwanda,2004,6086240,1997007,4089233,0.6718816543547412
Rwanda,2005,6391515,1978660,4412855,0.6904239448706606
Rwanda,2006,6879676,1960619,4919057,0.7150128872348058
Rwanda,2007,7194205,1942878,5251327,0.7299384713112845
Rwanda,2008,11325272,1925433,9399839,0.829987924351839
Rwanda,2009,12874140,4457155,8416985,0.6537900784052372
Rwanda,2010,14671517,6155274,8516243,0.5804609707367002
Rwanda,2011,19090925,7893330,11197595,0.5865402016926891
Rwanda,2012,24367094,7948704,16418390,0.673793518422837
Rwanda,2013,21932657,9019796,12912861,0.5887504190668736
Rwanda,2014,27789642,14992770,12796872,0.46049071089148974
Rwanda,2015,30629300,19828149,10801151,0.35264113120443497
Rwanda,2016,30880826,21088635,9792191,0.3170961489177783
Rwanda,2017,32957676,21041547,11916129,0.36155853343542793
Rwanda,2018,36136008,22045657,14090351,0.389925500348572
Rwanda,2019,43669544,24477712,19191832,0.4394786444300861
Rwanda,2020,56172855,28202583,27970272,0.4979321773835423
Sierra Leone,2007,1092547,8800789,-7708242,-7.055295561655471
Sierra Leone,2008,5189664,12830387,-7640723,-1.4722962796820758
Sierra Leone,2009,6842058,12653552,-5811494,-0.8493780672423414
Sierra Leone,2010,14491647,16607463,-2115816,-0.146002452309251
Sierra Leone,2011,15771614,16379472,-607858,-0.03854126787531067
Sierra Leone,2012,12759083,16155280,-3396197,-0.26617876848986716
Sierra Leone,2013,11875367,15934824,-4059457,-0.34183844591918716
Sierra Leone,2014,19342439,16074015,3268424,0.16897682862021693
Sierra Leone,2015,17635706,16988058,647648,0.03672367865511026
Sierra Leone,2016,22401374,17500438,4900936,0.2187783660055852
Sierra Leone,2017,22923074,17263936,5659138,0.24687517913173426
Sierra Leone,2018,23906075,17190363,6715712,0.2809207283085994
Sierra Leone,2019,25459563,16959484,8500079,0.33386586407630015
Sierra Leone,2020,25288620,16732452,8556168,0.3383406449224987
Slovak Republic,1995,152540726,92853264,59687462,0.3912886975508429
Slovak Republic,1996,43595069,102940466,-59345397,-1.361286915270165
Slovak Republic,1997,38285803,103668688,-65382885,-1.707757964486209
Slovak Republic,1998,39665492,105231254,-65565762,-1.652967319805336
Slovak Republic,1999,57538896,104869316,-47330420,-0.8225813022203277
Slovak Republic,2000,81987533,104386516,-22398983,-0.2731998656429874
Slovak Republic,2001,111242180,103487588,7754592,0.0697090977541073
Slovak Republic,2002,124846858,102603642,22243216,0.17816400313414374
Slovak Republic,2003,124789459,102170056,22619403,0.18126052617953892
Slovak Republic,2004,182834641,104440795,78393846,0.42876910836606724
Slovak Republic,2005,209253974,103556469,105697505,0.5051158789462226
Slovak Republic,2006,211297070,102924667,108372403,0.5128911773362499
Slovak Republic,2007,234548671,102555083,131993588,0.562755642303341
Slovak Republic,2008,231542831,109916283,121626548,0.525287470463726
Slovak Republic,2009,253130060,108979556,144150504,0.5694720887752328
Slovak Republic,2010,280055450,116200052,163855398,0.5850819828716063
Slovak Republic,2011,228416218,117199939,111216279,0.4869018495000211
Slovak Republic,2012,235453083,116185938,119267145,0.5065431443087114
Slovak Republic,2013,288643729,115485945,173157784,0.5999014238067857
Slovak Republic,2014,225455590,114501802,110953788,0.4921314570199834
Slovak Republic,2015,165492958,113534062,51958896,0.3139643923700971
Slovak Republic,2016,185242933,113079732,72163201,0.3895598057713759
Slovak Republic,2017,180311021,112137855,68173166,0.37808651751797245
Slovak Republic,2018,161726789,112509464,49217325,0.30432388662585763
Slovak Republic,2019,198463068,111582733,86880335,0.4377657559944604
Slovak Republic,2020,223785392,111206889,112578503,0.5030645744741015
Slovenia,1995,193837982,42508261,151329721,0.7807021071855773
Slovenia,1996,217578276,42172090,175406186,0.806175088913748
Slovenia,1997,167478440,41841522,125636918,0.7501677111394159
Slovenia,1998,189084878,50692943,138391935,0.7319037696922542
Slovenia,1999,199616097,51265466,148350631,0.7431796995810414
Slovenia,2000,186472127,56585488,129886639,0.696547205685062
Slovenia,2001,183263263,64155505,119107758,0.6499270833129278
Slovenia,2002,172861147,72745083,100116064,0.5791704251505401
Slovenia,2003,189011307,77494621,111516686,0.5900000786725421
Slovenia,2004,294597362,76743338,217854024,0.7394975383384458
Slovenia,2005,255009608,77157629,177851979,0.6974324630152758
Slovenia,2006,273386016,83550535,189835481,0.6943862154236887
Slovenia,2007,277856906,84932324,192924582,0.6943307070438623
Slovenia,2008,375574569,86342011,289232558,0.7701068758997897
Slovenia,2009,480438857,96268195,384170662,0.7996244608499683
Slovenia,2010,465068955,96429146,368639809,0.7926562395462411
Slovenia,2011,398824668,95469315,303355353,0.7606233448929994
Slovenia,2012,418052884,94817426,323235458,0.7731927475472218
Slovenia,2013,546352539,107255617,439096922,0.8036878950058288
Slovenia,2014,719421801,106174745,613247056,0.8524165588915757
Slovenia,2015,372196781,105111887,267084894,0.717590553261663
Slovenia,2016,442660922,104066744,338594178,0.7649064129496391
Slovenia,2017,383137184,111045786,272091398,0.7101670351056294
Slovenia,2018,488388615,109936557,378452058,0.7748994271703078
Slovenia,2019,445075436,110735392,334340044,0.7511985990617555
Slovenia,2020,474943026,109945689,364997337,0.7685076251651287
South Africa,1995,23116362,55201912,-32085550,-1.3880017106497986
South Africa,1996,41020629,119935883,-78915254,-1.9237943425977209
South Africa,1997,55741821,118393293,-62651472,-1.1239581139625847
South Africa,1998,42325819,116876413,-74550594,-1.7613503001560349
South Africa,1999,35266153,115384814,-80118661,-2.2718287702092144
South Africa,2000,72394583,113918076,-41523493,-0.5735718237371434
South Africa,2001,73564287,122303338,-48739051,-0.6625368502518076
South Africa,2002,44579033,120749369,-76170336,-1.7086583282324674
South Africa,2003,33020128,174631853,-141611725,-4.288648578224772
South Africa,2004,54112005,172364058,-118252053,-2.185320115194401
South Africa,2005,61369347,170134060,-108764713,-1.7722970557271858
South Africa,2006,141538797,167941228,-26402431,-0.18653847255745717
South Africa,2007,59123068,165784944,-106661876,-1.8040653100072548
South Africa,2008,63422546,163664598,-100242052,-1.5805428561634849
South Africa,2009,90154769,167596609,-77441840,-0.8589877258739358
South Africa,2010,163700570,170086393,-6385823,-0.03900916777504196
South Africa,2011,193573140,167924757,25648383,0.1324997001133525
South Africa,2012,120861699,165799147,-44937448,-0.37180883912611556
South Africa,2013,94882671,163708965,-68826294,-0.7253831840378946
South Africa,2014,79468514,161653619,-82185105,-1.0341844947547403
South Africa,2015,57290544,165023614,-107733070,-1.8804686162519246
South Africa,2016,49744623,162961760,-113217137,-2.27596733419811
South Africa,2017,73717188,160934270,-87217082,-1.18313088665292
South Africa,2018,85560588,158940572,-73379984,-0.8576376777588298
South Africa,2019,64918367,156980102,-92061735,-1.4181153848185983
South Africa,2020,102998222,155052307,-52054085,-0.5053881900990485
Spain,1995,1045832262,832134930,213697332,0.20433231959333073
Spain,1996,1681988150,837379403,844608747,0.5021490472450713
Spain,1997,1311311371,830380673,480930698,0.36675553086468277
Spain,1998,1245402303,823498589,421903714,0.3387690170346505
Spain,1999,799929443,846604966,-46675523,-0.05834954996149579
Spain,2000,829239851,1004138461,-174898610,-0.21091438115170855
Spain,2001,1110480054,1004430338,106049716,0.09549898318119633
Spain,2002,606598050,1003220253,-396622203,-0.6538468150367447
Spain,2003,1391003976,994376386,396627590,0.28513763931901226
Spain,2004,1179294321,1002567501,176726820,0.14985811162911553
Spain,2005,707133603,1001251301,-294117698,-0.41592946050394386
Spain,2006,1069902002,1006737440,63164562,0.05903770801617773
Spain,2007,1277102278,1006033785,271068493,0.212252767589222
Spain,2008,1282455941,1009316152,273139789,0.21298181112328754
Spain,2009,1517175616,1008861573,508314043,0.3350396866647242
Spain,2010,2505201379,1008636305,1496565074,0.5973831431457152
Spain,2011,2170687068,1001461872,1169225196,0.5386429086147759
Spain,2012,1477462200,995899866,481562334,0.32593885244576815
Spain,2013,2703584846,987523812,1716061034,0.6347354093728339
Spain,2014,3201480768,990787495,2210693273,0.6905221156087232
Spain,2015,1973968589,1141477343,832491246,0.4217347989421325
Spain,2016,2443648156,1138129303,1305518853,0.5342499286546226
Spain,2017,1334837455,1128152951,206684504,0.1548387058108135
Spain,2018,2675285623,1118491337,1556794286,0.5819170381718902
Spain,2019,1772596451,1117849660,654746791,0.3693716021097912
Spain,2020,2100723688,1109034188,991689500,0.4720704134793381
Sri Lanka,1995,257857842,65830666,192027176,0.7447017104874398
Sri Lanka,1996,176828016,65487967,111340049,0.6296516328046117
Sri Lanka,1997,187083141,64786410,122296731,0.6537025749423354
Sri Lanka,1998,197025761,64284492,132741269,0.6737254475063289
Sri Lanka,1999,205550734,64175180,141375554,0.6877890983352071
Sri Lanka,2000,154848068,64861892,89986176,0.5811255972531734
Sri Lanka,2001,143634262,66403725,77230537,0.537688821069725
Sri Lanka,2002,129910922,67896006,62014916,0.47736491316719315
Sri Lanka,2003,172011731,79523185,92488546,0.537687432492613
Sri Lanka,2004,162866383,85827206,77039177,0.4730207399522098
Sri Lanka,2005,194629190,87061693,107567497,0.55267915876339
Sri Lanka,2006,268081748,91214959,176866789,0.6597494619439739
Sri Lanka,2007,251720907,91624823,160096084,0.6360063051894216
Sri Lanka,2008,261025365,95512200,165513165,0.6340884342791744
Sri Lanka,2009,230000743,103109525,126891218,0.5516991655979129
Sri Lanka,2010,363098888,102989336,260109552,0.7163600897615527
Sri Lanka,2011,310917551,105713583,205203968,0.6599948035741475
Sri Lanka,2012,212748855,138850296,73898559,0.34735114790629545
Sri Lanka,2013,457610989,144432559,313178430,0.6843769872842804
Sri Lanka,2014,365124503,153486703,211637800,0.5796318742267483
Sri Lanka,2015,391469382,156079593,235389789,0.6012980831282483
Sri Lanka,2016,276180792,165403745,110777047,0.40110337217079167
Sri Lanka,2017,282209960,165896642,116313318,0.4121517114420767
Sri Lanka,2018,409451291,178306320,231144971,0.5645237323235109
Sri Lanka,2019,294807206,181170325,113636881,0.38546168033626693
Sri Lanka,2020,308135598,178891953,129243645,0.41943756527605097
Suriname,1995,19767157,20173956,-406799,-0.020579540092690113
Suriname,1996,21861064,19922694,1938370,0.08866768790393734
Suriname,1997,23593293,19675620,3917673,0.1660502838666904
Suriname,1998,28270913,19432663,8838250,0.31262697458691907
Suriname,1999,27110654,19193756,7916898,0.29202165318475903
Suriname,2000,23877278,18958831,4918447,0.20598859719269508
Suriname,2001,20119173,18727821,1391352,0.06915552642248267
Suriname,2002,17189607,18500661,-1311054,-0.07627015556551119
Suriname,2003,17200668,18277288,-1076620,-0.06259175515741598
Suriname,2004,17227776,18057637,-829861,-0.048169943700219923
Suriname,2005,16410009,17841647,-1431638,-0.0872417559307859
Suriname,2006,22363099,17629257,4733842,0.21168094815481522
Suriname,2007,27398132,17420406,9977726,0.3641754116667516
Suriname,2008,35951535,17215037,18736498,0.5211598892787193
Suriname,2009,38848695,17013090,21835605,0.5620679150226282
Suriname,2010,37621849,16814509,20807340,0.553065321164837
Suriname,2011,50077712,16619238,33458474,0.6681310440061639
Suriname,2012,42315685,16427221,25888464,0.611793570161986
Suriname,2013,37625600,16238405,21387195,0.5684213673668991
Suriname,2014,26296242,16052735,10243507,0.38954261981616994
Suriname,2015,27481287,15870160,11611127,0.4225103067407287
Suriname,2016,58321162,15690628,42630534,0.7309616704824914
Suriname,2017,57363108,15514089,41849019,0.7295458781626686
Suriname,2018,62157564,15340491,46817073,0.7531999323525613
Suriname,2019,59256028,15169787,44086241,0.7439958851106254
Suriname,2020,69291411,15001928,54289483,0.7834951289994657
Sweden,1995,1608032103,932817554,675214549,0.4199011622593209
Sweden,1996,1416904422,931147908,485756514,0.3428294149257726
Sweden,1997,1746795373,994604060,752191313,0.43061215104329226
Sweden,1998,1951448225,986252576,965195649,0.49460479485690684
Sweden,1999,1913571468,1010240280,903331188,0.4720655607099593
Sweden,2000,2011291956,1011035431,1000256525,0.4973204024488228
Sweden,2001,1900124590,1006166805,893957785,0.4704732467043122
Sweden,2002,1785570481,997818450,787752031,0.4411766655992338
Sweden,2003,1825760532,989609235,836151297,0.45797424270314985
Sweden,2004,2368475261,1009319640,1359155621,0.5738525723195215
Sweden,2005,2954265901,1001039533,1953226368,0.6611545586803291
Sweden,2006,2541032067,992897428,1548134639,0.6092542707765837
Sweden,2007,3237604602,1038135855,2199468747,0.6793506364678685
Sweden,2008,3775111227,1029606977,2745504250,0.7272644658424524
Sweden,2009,3194175333,1050505341,2143669992,0.6711184479615415
Sweden,2010,3615828845,1055972462,2559856383,0.7079583942530333
Sweden,2011,4114563125,1047334829,3067228296,0.7454566141818519
Sweden,2012,4415521488,1038841156,3376680332,0.764729679422183
Sweden,2013,3583816332,1045384238,2538432094,0.7083041815882879
Sweden,2014,3418169808,1036987837,2381181971,0.6966248328058487
Sweden,2015,3209641945,1092495137,2117146808,0.6596208687072103
Sweden,2016,2698896478,1103588147,1595308331,0.5910965255629934
Sweden,2017,2903821831,1114671588,1789150243,0.6161363703171361
Sweden,2018,3047335304,1105571905,1941763399,0.6372004408084657
Sweden,2019,3188342797,1104813023,2083529774,0.653483614108386
Sweden,2020,3149523206,1095913255,2053609951,0.6520383615804989
Switzerland,1995,1408179376,203625362,1204554014,0.8553981364374137
Switzerland,1996,1133677526,202374602,931302924,0.8214883885772646
Switzerland,1997,1127727379,200604726,927122653,0.8221159388912912
Switzerland,1998,1107574808,203605612,903969196,0.8161698780711163
Switzerland,1999,1269922204,244892164,1025030040,0.8071597116511241
Switzerland,2000,1024562163,243257869,781304294,0.762573831257128
Switzerland,2001,1124575140,242279455,882295685,0.7845591224789124
Switzerland,2002,1031272417,242409489,788862928,0.7649413627243363
Switzerland,2003,1158112982,243683664,914429318,0.7895855863914321
Switzerland,2004,1201606519,241466740,960139779,0.799046746017196
Switzerland,2005,1084604728,246666301,837938427,0.7725749347830614
Switzerland,2006,1024721323,247285175,777436148,0.7586805608025783
Switzerland,2007,1201037267,246518033,954519234,0.7947457254047056
Switzerland,2008,1390786176,246544079,1144242097,0.8227304216460661
Switzerland,2009,1461173376,254358314,1206815062,0.8259218801971929
Switzerland,2010,1622418141,262799692,1359618449,0.8380197525170547
Switzerland,2011,1801735221,272450657,1529284564,0.8487842975901951
Switzerland,2012,1969807422,278715754,1691091668,0.8585060900435576
Switzerland,2013,1958831274,280315708,1678515566,0.8568964505924056
Switzerland,2014,1987634577,287609528,1700025049,0.8553006013640102
Switzerland,2015,1969585812,299629316,1669956496,0.8478719159254382
Switzerland,2016,1759005275,306187752,1452817523,0.8259313054078249
Switzerland,2017,1740006749,311072392,1428934357,0.8212234566453397
Switzerland,2018,1854337668,320667276,1533670392,0.8270717995251338
Switzerland,2019,2016717543,326115131,1690602412,0.8382940971917752
Switzerland,2020,2124215965,323055639,1801160326,0.8479177050154597
Tajikistan,1995,15146505,333387285,-318240780,-21.010839134176496
Tajikistan,1996,23678731,329216759,-305538028,-12.903479835976007
Tajikistan,1997,19761964,325115741,-305353777,-15.45159059089471
Tajikistan,1998,211122321,321083074,-109960753,-0.5208390684564329
Tajikistan,1999,181980243,317117618,-135137375,-0.7425936616646897
Tajikistan,2000,121966734,313218253,-191251519,-1.568062968710796
Tajikistan,2001,150238115,309383877,-159145762,-1.0592901941028747
Tajikistan,2002,154705625,305613408,-150907783,-0.975451170569913
Tajikistan,2003,175149589,301905779,-126756190,-0.723702468979245
Tajikistan,2004,193055934,298259945,-105204011,-0.5449405714718927
Tajikistan,2005,204635160,295986617,-91351457,-0.4464113449516691
Tajikistan,2006,209365853,292442635,-83076782,-0.39680196560037895
Tajikistan,2007,232601052,290115345,-57514293,-0.24726583351824222
Tajikistan,2008,260064074,350946102,-90882028,-0.34946014111891516
Tajikistan,2009,230638974,412608868,-181969894,-0.7889815448103754
Tajikistan,2010,269660878,410363116,-140702238,-0.5217747529547093
Tajikistan,2011,252973887,405240460,-152266573,-0.6019062868730004
Tajikistan,2012,314129932,503383195,-189253263,-0.6024680990921935
Tajikistan,2013,315317889,498765190,-183447301,-0.5817852630619381
Tajikistan,2014,312049715,513041240,-200991525,-0.6441009728209494
Tajikistan,2015,276078499,506561027,-230482528,-0.8348441795896608
Tajikistan,2016,220253798,500539405,-280285607,-1.2725574294069608
Tajikistan,2017,243758275,494221236,-250462961,-1.0275054703271098
Tajikistan,2018,277726052,501231608,-223505556,-0.8047698600489953
Tajikistan,2019,329382920,494934154,-165551234,-0.5026102567795562
Tajikistan,2020,539029824,509705747,29324077,0.05440158539353845
Tanzania,1995,192495058,29194220,163300838,0.8483378207039476
Tanzania,1996,216372122,28911032,187461090,0.8663828235691102
Tanzania,1997,167996366,28632563,139363803,0.8295643906964035
Tanzania,1998,243758415,28358735,215399680,0.8836604881927871
Tanzania,1999,244297887,28089472,216208415,0.8850195867637611
Tanzania,2000,202078289,27824696,174253593,0.8623073456446377
Tanzania,2001,226462560,27564333,198898227,0.8782830459922382
Tanzania,2002,239476567,49716517,189760050,0.7923950655263903
Tanzania,2003,263160627,49155313,214005314,0.813211749947685
Tanzania,2004,290038216,48603463,241434753,0.8324239347824426
Tanzania,2005,245331948,48060811,197271137,0.8040988489603482
Tanzania,2006,210400408,47527203,162873205,0.7741106899374454
Tanzania,2007,416718998,47002488,369716510,0.8872081949093187
Tanzania,2008,507298424,46486519,460811905,0.9083645507244864
Tanzania,2009,489197898,46246572,442951326,0.9054644915910902
Tanzania,2010,493414634,45743965,447670669,0.9072910249354299
Tanzania,2011,389198668,45249735,343948933,0.8837361514299941
Tanzania,2012,328936772,44763742,284173030,0.8639138405602156
Tanzania,2013,331764346,44285849,287478497,0.8665141401300548
Tanzania,2014,499326905,43815921,455510984,0.9122500298677076
Tanzania,2015,342262256,44252339,298009917,0.8707063422149592
Tanzania,2016,364113914,44853541,319260373,0.876814537221997
Tanzania,2017,363590896,44379770,319211126,0.8779403706521849
Tanzania,2018,374800155,44847944,329952211,0.8803417143730904
Tanzania,2019,384512870,47046793,337466077,0.877645726136553
Tanzania,2020,491931109,46546765,445384344,0.905379505080253
Thailand,1995,511961913,159113697,352848216,0.689207941138387
Thailand,1996,559846916,182295402,377551514,0.6743834845023956
Thailand,1997,451278632,182670861,268607771,0.5952149114828907
Thailand,1998,250284590,180817070,69467520,0.2775541234879862
Thailand,1999,190077021,178806673,11270348,0.05929358499363266
Thailand,2000,330644267,179364130,151280137,0.4575314079164119
Thailand,2001,317572186,177384130,140188056,0.4414368202887894
Thailand,2002,397196339,175437130,221759209,0.5583113116256593
Thailand,2003,408073603,181162780,226910823,0.5560536661323815
Thailand,2004,341417433,264134532,77282901,0.2263589773987903
Thailand,2005,328949634,260967554,67982080,0.2066640998299454
Thailand,2006,546133649,257853359,288280290,0.5278566712156569
Thailand,2007,582075232,254791067,327284165,0.5622712443466414
Thailand,2008,520151892,253195113,266956779,0.5132285071069203
Thailand,2009,566066020,251875973,314190047,0.5550413483572111
Thailand,2010,463138912,248920810,214218102,0.46253531381098895
Thailand,2011,727716011,246014900,481701111,0.6619355678845988
Thailand,2012,823887484,245808764,578078720,0.7016476536254798
Thailand,2013,568297991,242961188,325336803,0.5724757225122762
Thailand,2014,528536441,241892586,286643855,0.5423350837600998
Thailand,2015,348178527,241528708,106649819,0.3063078585544134
Thailand,2016,296445908,238762578,57683330,0.19458298611428296
Thailand,2017,412143058,236042549,176100509,0.4272800562371719
Thailand,2018,728952244,283358739,445593505,0.6112794201097212
Thailand,2019,633180040,280038976,353141064,0.5577261468949652
Thailand,2020,442030784,276752989,165277795,0.3739056214691147
Togo,1995,18823329,5324180,13499149,0.7171499260306187
Togo,1996,14531400,5265181,9266219,0.6376687036348873
Togo,1997,7141787,5207166,1934621,0.27088752436890096
Togo,1998,13885054,5150118,8734936,0.6290890910471072
Togo,1999,12984640,5094021,7890619,0.6076886998792419
Togo,2000,8597062,5038859,3558203,0.41388592986766876
Togo,2001,5794085,4984616,809469,0.13970609682115467
Togo,2002,8263752,4931277,3332475,0.4032641589437824
Togo,2003,15666806,4878827,10787979,0.6885882802148696
Togo,2004,14186306,4827251,9359055,0.6597245963818911
Togo,2005,14722884,4930431,9792453,0.6651178532684221
Togo,2006,14324861,4878434,9446427,0.6594428385727442
Togo,2007,15732680,4827305,10905375,0.6931670255798758
Togo,2008,17241755,4943073,12298682,0.7133080130183963
Togo,2009,21719719,4891340,16828379,0.7747972706276725
Togo,2010,18011256,4840470,13170786,0.7312530564220507
Togo,2011,20746978,4790448,15956530,0.769101408407528
Togo,2012,17846505,4741259,13105246,0.7343312318014087
Togo,2013,8325570,4692890,3632680,0.43632808324234856
Togo,2014,13724250,4645327,9078923,0.6615241634333388
Togo,2015,6021948,4598557,1423391,0.2363672021080222
Togo,2016,21117898,4552567,16565331,0.7844213945914503
Togo,2017,21272033,6758314,14513719,0.6822911096461726
Togo,2018,21637907,6682759,14955148,0.6911550179044581
Togo,2019,24602104,6608463,17993641,0.7313862668005956
Togo,2020,19329596,6535406,12794190,0.6618963996971277
Turkiye,1995,1614053087,464010087,1150043000,0.7125186954894749
Turkiye,1996,2138980182,470200056,1668780126,0.7801755902383578
Turkiye,1997,1903428439,490068233,1413360206,0.7425339335281415
Turkiye,1998,1998037942,515427276,1482610666,0.7420332891756467
Turkiye,1999,1738888982,544525877,1194363105,0.6868541450106215
Turkiye,2000,1564055081,635151828,928903253,0.5939069948905463
Turkiye,2001,1207172475,705279275,501893200,0.41575931392902243
Turkiye,2002,2010619954,786496750,1224123204,0.6088287354179914
Turkiye,2003,2241990593,831872878,1410117715,0.6289579088345444
Turkiye,2004,3071238114,833748730,2237489384,0.7285300914313934
Turkiye,2005,2796261750,868732588,1927529162,0.6893235806697996
Turkiye,2006,2941485909,886600812,2054885097,0.6985874352526092
Turkiye,2007,2613100726,936132298,1676968428,0.6417542237520315
Turkiye,2008,3282814470,1004615399,2278199071,0.6939774062224113
Turkiye,2009,3554802426,1125633852,2429168574,0.6833484067167676
Turkiye,2010,5707821654,1307498036,4400323618,0.7709287158466637
Turkiye,2011,5298904514,1495273786,3803630728,0.7178145441101262
Turkiye,2012,6398651443,1868974218,4529677225,0.7079112318198515
Turkiye,2013,6775105392,2278014648,4497090744,0.6637669060189285
Turkiye,2014,4136610773,2471814371,1664796402,0.40245420547329797
Turkiye,2015,5858996207,2809536835,3049459372,0.5204747134597352
Turkiye,2016,5505701186,2967941090,2537760096,0.46093313281386644
Turkiye,2017,3943199823,3074258515,868941308,0.22036451283336345
Turkiye,2018,3743803844,3288892909,454910935,0.12151035523110061
Turkiye,2019,5643729198,3300601881,2343127317,0.41517359086441413
Turkiye,2020,4816562288,3896233236,920329052,0.19107591617633826
Uganda,1995,142617123,12241486,130375637,0.9141653839139638
Uganda,1996,151062079,12884626,138177453,0.9147064168235101
Uganda,1997,169753386,12754673,156998713,0.9248635134735987
Uganda,1998,150102693,12626886,137475807,0.9158783513630898
Uganda,1999,146998641,13830204,133168437,0.9059161097958722
Uganda,2000,153913085,26643234,127269851,0.8268942890723033
Uganda,2001,148578455,26324782,122253673,0.8228223466181553
Uganda,2002,156185598,31711746,124473852,0.7969611385039483
Uganda,2003,160348762,37575405,122773357,0.7656645144538129
Uganda,2004,194791162,37108894,157682268,0.8094939543509679
Uganda,2005,205543111,46623387,158919724,0.7731697901565769
Uganda,2006,140249964,46034572,94215392,0.6717676733236095
Uganda,2007,176321427,45455570,130865857,0.7422005324401101
Uganda,2008,209128014,44886218,164241796,0.785364872254752
Uganda,2009,179458585,48671980,130786605,0.7287843320507625
Uganda,2010,178869446,56135410,122734036,0.686165461707753
Uganda,2011,213234176,68821988,144412188,0.6772469156163785
Uganda,2012,383770915,96013473,287757442,0.7498156602096853
Uganda,2013,509935581,114718605,395216976,0.7750331428628041
Uganda,2014,492119597,113828842,378290755,0.7686967909957059
Uganda,2015,418607582,112332737,306274845,0.7316514515496759
Uganda,2016,441600397,110861568,330738829,0.7489550082990528
Uganda,2017,463305668,115003535,348302133,0.7517761103669468
Uganda,2018,512944771,127204524,385740247,0.7520112667256335
Uganda,2019,594295932,201496452,392799480,0.6609492995822829
Uganda,2020,593592347,201476133,392116214,0.6605816533547728
Ukraine,1995,191764622,1130106344,-938341722,-4.893195169231998
Ukraine,1996,242307991,1113568723,-871260732,-3.5956747790459787
Ukraine,1997,313550531,1097306730,-783756199,-2.499616876745139
Ukraine,1998,418108597,1081315769,-663207172,-1.5862079296111675
Ukraine,1999,224588488,1068990032,-844401544,-3.759772157155268
Ukraine,2000,226171173,1053690289,-827519116,-3.6588178105261893
Ukraine,2001,273554286,1039704202,-766149916,-2.8007234951529876
Ukraine,2002,222510704,1027256896,-804746192,-3.616662828049836
Ukraine,2003,224323956,1015841837,-791517881,-3.528458997932437
Ukraine,2004,312008102,1002932830,-690924728,-2.2144448287435816
Ukraine,2005,386869550,988569035,-601699485,-1.5553032928024446
Ukraine,2006,446251426,987477557,-541226131,-1.2128277904931557
Ukraine,2007,396347300,983541557,-587194257,-1.4815144621901044
Ukraine,2008,534666604,976319628,-441653024,-0.8260344309815917
Ukraine,2009,419777231,977820016,-558042785,-1.3293784030892328
Ukraine,2010,498888816,974458667,-475569851,-0.953258192502756
Ukraine,2011,442670853,960810931,-518140078,-1.1704860947779636
Ukraine,2012,445919474,947682602,-501763128,-1.1252325974891153
Ukraine,2013,585747483,940127468,-354379985,-0.6050047081465649
Ukraine,2014,271125334,938577868,-667452534,-2.46178593550391
Ukraine,2015,139668979,935381707,-795712728,-5.697132847230164
Ukraine,2016,193339877,922503580,-729163703,-3.771408745646404
Ukraine,2017,313272554,920864704,-607592150,-1.9395001006056853
Ukraine,2018,353405707,916063189,-562657482,-1.5921007240553702
Ukraine,2019,235466914,916305395,-680838481,-2.891440115446538
Ukraine,2020,195512800,904283865,-708771065,-3.625190089856009
United Kingdom,1995,132838082,103062845,29775237,0.22414684517953218
United Kingdom,1996,101459405,106631346,-5171941,-0.05097547142130392
United Kingdom,1997,115597866,112197507,3400359,0.02941541325685026
United Kingdom,1998,133031581,111227581,21804000,0.1639009311631048
United Kingdom,1999,156846350,110675905,46170445,0.29436735378285817
United Kingdom,2000,207468759,111378196,96090563,0.46315678304124813
United Kingdom,2001,102029970,128879983,-26850013,-0.2631580995270311
United Kingdom,2002,125929208,127721131,-1791923,-0.014229605890954226
United Kingdom,2003,93401052,126581593,-33180541,-0.35524804367299845
United Kingdom,2004,166725310,128591879,38133431,0.22872010854260819
United Kingdom,2005,185108181,127912663,57195518,0.3089842798466049
United Kingdom,2006,205751652,130114545,75637107,0.36761360730168036
United Kingdom,2007,259453431,130674745,128778686,0.49634605140372956
United Kingdom,2008,280983693,145585481,135398212,0.4818721348359529
United Kingdom,2009,249655729,147261033,102394696,0.4101435861702176
United Kingdom,2010,165210056,147881473,17328583,0.10488818549882944
United Kingdom,2011,297624223,155704937,141919286,0.47684050904687286
United Kingdom,2012,288187627,158355061,129832566,0.45051401877152764
United Kingdom,2013,270431156,161645307,108785849,0.40226818022402716
United Kingdom,2014,372766561,166502984,206263577,0.5533317592829899
United Kingdom,2015,362016646,179313060,182703586,0.504682831628687
United Kingdom,2016,273023923,185785110,87238813,0.31952809131674514
United Kingdom,2017,301558897,193406237,108152660,0.35864523008916566
United Kingdom,2018,311765589,193343903,118421686,0.37984206781717655
United Kingdom,2019,352762484,191756377,161006107,0.45641505064353727
United Kingdom,2020,325406942,189932292,135474650,0.4163237857414855
United States,1995,7316500642,6053689709,1262810933,0.17259766585010572
United States,1996,8138337010,6005682434,2132654576,0.2620504131715725
United States,1997,7786038969,6437397810,1348641159,0.17321274198210349
United States,1998,6850457687,6385077672,465380015,0.06793414925883623
United States,1999,6341253343,6333629537,7623806,0.0012022553882689118
United States,2000,5813563840,6591145827,-777581987,-0.13375306583027047
United States,2001,4480397600,6537602818,-2057205218,-0.45915684313374333
United States,2002,6321015220,6624611211,-303595991,-0.04802962505760269
United States,2003,6786135134,6571117658,215017476,0.031684820852257434
United States,2004,6809399688,6518515665,290884023,0.042718012795256555
United States,2005,7206606162,6466790371,739815791,0.10265800216765057
United States,2006,8501676979,6468154559,2033522420,0.23919074142936805
United States,2007,7444337513,6429460136,1014877377,0.13632877005210015
United States,2008,8095835389,6415457660,1680377729,0.20756075787844802
United States,2009,8879399564,6485313138,2394086426,0.269622558230898
United States,2010,8501509749,6490636819,2010872930,0.2365312737818752
United States,2011,10555287570,6440572346,4114715224,0.3898250234029389
United States,2012,9263610073,6407574485,2856035588,0.3083069737924622
United States,2013,9194802803,6447708450,2747094353,0.2987659889893127
United States,2014,9164733239,6493318897,2671414342,0.29148849970143687
United States,2015,8891760410,6444077022,2447683388,0.2752754544811223
United States,2016,9475448724,6470254929,3005193795,0.31715582897813166
United States,2017,10910315489,6421721797,4488593692,0.4114082398923744
United States,2018,10647846993,6394799625,4253047368,0.39942791916487863
United States,2019,10560042518,6347614526,4212427992,0.39890255979743966
United States,2020,10609476898,6352738328,4256738570,0.4012204004895322
Uruguay,1995,795951190,154830778,641120412,0.8054770443901215
Uruguay,1996,801356150,154041681,647314469,0.807773758272149
Uruguay,1997,911617155,155284227,756332928,0.8296607011525579
Uruguay,1998,1285380835,153409289,1131971546,0.8806507108066537
Uruguay,1999,753606575,151565601,602040974,0.7988796727257853
Uruguay,2000,948698868,149752641,798946227,0.8421494469412606
Uruguay,2001,1172771814,147969896,1024801918,0.8738289117852214
Uruguay,2002,868590695,146216865,722373830,0.8316619486696205
Uruguay,2003,698955836,144493050,554462786,0.7932729901406818
Uruguay,2004,420240604,142797965,277442639,0.6601995056146455
Uruguay,2005,721365949,141131132,580234817,0.8043557057334848
Uruguay,2006,416857064,139492080,277364984,0.6653719175069563
Uruguay,2007,1041546030,137880345,903665685,0.8676195376597998
Uruguay,2008,704327309,136295472,568031837,0.8064884461266857
Uruguay,2009,786937510,134737014,652200496,0.828783083424248
Uruguay,2010,1569618464,133204530,1436413934,0.9151357268947111
Uruguay,2011,1316673785,131697588,1184976197,0.8999770561999911
Uruguay,2012,1132413480,130215761,1002197719,0.8850104106849734
Uruguay,2013,1847841844,128758631,1719083213,0.9303194527074472
Uruguay,2014,1865469208,127325787,1738143421,0.9317459722980321
Uruguay,2015,1394882686,125916824,1268965862,0.9097294523304449
Uruguay,2016,1319053780,124531343,1194522437,0.9055903975348147
Uruguay,2017,1433878495,123168954,1310709541,0.9141008429727513
Uruguay,2018,1204563284,121829271,1082734013,0.898860215467102
Uruguay,2019,1333784913,120511916,1213272997,0.9096466642969143
Uruguay,2020,610144877,119216517,490928360,0.8046094927713373
"Venezuela, RB",1995,4656907881,983798486,3673109395,0.7887442674110307
"Venezuela, RB",1996,4690194542,1233592100,3456602442,0.7369848757970773
"Venezuela, RB",1997,4957205935,1353726548,3603479387,0.7269174277303854
"Venezuela, RB",1998,4882459865,1371343143,3511116722,0.719128639882839
"Venezuela, RB",1999,5610699356,1354633746,4256065610,0.7585624072779137
"Venezuela, RB",2000,6780534154,1338202839,5442331315,0.8026404987267025
"Venezuela, RB",2001,6326493498,1322045781,5004447717,0.7910302474162125
"Venezuela, RB",2002,4892882080,1306158007,3586724073,0.7330493591212809
"Venezuela, RB",2003,4746767249,1290535029,3456232220,0.7281233813872217
"Venezuela, RB",2004,5976266376,1542108473,4434157903,0.7419612219440334
"Venezuela, RB",2005,7863026297,1651927473,6211098824,0.7899119994511192
"Venezuela, RB",2006,9201373467,1650587018,7550786449,0.8206151479537592
"Venezuela, RB",2007,10887286998,1630407737,9256879261,0.8502466466347854
"Venezuela, RB",2008,14749083269,1610677361,13138405908,0.890794747604052
"Venezuela, RB",2009,13990427747,1598133078,12392294669,0.8857695342200891
"Venezuela, RB",2010,13577236766,1578848264,11998388502,0.8837135794852058
"Venezuela, RB",2011,15515414365,1559884863,13955529502,0.8994622491991693
"Venezuela, RB",2012,14613601614,1541358411,13072243203,0.8945257677256399
"Venezuela, RB",2013,14793420238,1583021370,13210398868,0.8929915229519623
"Venezuela, RB",2014,13107506324,1564160195,11543346129,0.8806668365182473
"Venezuela, RB",2015,11131541219,1607320217,9524221002,0.8556066778734532
"Venezuela, RB",2016,10545201680,1792799804,8752401876,0.8299890454062895
"Venezuela, RB",2017,9766814762,1771203111,7995611651,0.8186508954903838
"Venezuela, RB",2018,7113349839,1749968006,5363381833,0.7539881988644028
"Venezuela, RB",2019,5204480732,1729085181,3475395551,0.6677698948199314
"Venezuela, RB",2020,9308269097,1724783196,7583485901,0.8147041970933256
Vietnam,1995,622733923,174749584,447984339,0.7193832268553001
Vietnam,1996,717419310,182808192,534611118,0.7451864070957331
Vietnam,1997,625086619,180753946,444332673,0.7108337620645819
Vietnam,1998,456836952,178733938,278103014,0.6087577039958887
Vietnam,1999,623828197,222650279,401177918,0.6430903891957291
Vietnam,2000,609249765,250532445,358717320,0.5887853235363989
Vietnam,2001,717205313,313885488,403319825,0.56234918744948
Vietnam,2002,825413568,369462216,455951352,0.5523913946614456
Vietnam,2003,922453017,370148726,552304291,0.5987343320705948
Vietnam,2004,947605789,369909342,577696447,0.6096379461860801
Vietnam,2005,961687104,369516975,592170129,0.6157617446848908
Vietnam,2006,1218628363,424632597,793995766,0.6515487330734316
Vietnam,2007,1475373821,541253116,934120705,0.6331417107339333
Vietnam,2008,1885744853,628266925,1257477928,0.6668335464363058
Vietnam,2009,2179538621,740407490,1439131131,0.6602916402278334
Vietnam,2010,2602030870,898883116,1703147754,0.6545455604068218
Vietnam,2011,3631470151,1402657092,2228813059,0.6137495191544533
Vietnam,2012,5029075427,2034537666,2994537761,0.5954449887394779
Vietnam,2013,5306941135,2228797202,3078143933,0.5800222491067824
Vietnam,2014,5427430683,2295750798,3131679885,0.5770096511428813
Vietnam,2015,4733321349,2428059984,2305261365,0.48702828205125526
Vietnam,2016,5001184345,2670067263,2331117082,0.4661130086777475
Vietnam,2017,6858426314,2789604386,4068821928,0.5932588237762906
Vietnam,2018,6741881536,2792945889,3948935647,0.5857319838554933
Vietnam,2019,5991055181,3307517565,2683537616,0.4479240359044859
Vietnam,2020,5353083542,3379587773,1973495769,0.36866522883793246
Zambia,1995,581013429,138897896,442115533,0.7609385789256861
Zambia,1996,544086220,137356030,406730190,0.7475473096892621
Zambia,1997,605592845,135839861,469752984,0.7756911064561868
Zambia,1998,608601317,134348962,474252355,0.779249636424957
Zambia,1999,493288413,132882911,360405502,0.7306182194877543
Zambia,2000,462442560,131441294,331001266,0.71576730740354
Zambia,2001,531938171,130023704,401914467,0.7555661332677703
Zambia,2002,525257553,132477313,392780240,0.7477859913801183
Zambia,2003,549876554,131053450,418823104,0.7616675069219263
Zambia,2004,596356660,129653317,466703343,0.7825909800353366
Zambia,2005,681834932,128276520,553558412,0.81186572588217
Zambia,2006,810701113,126922669,683778444,0.8434408600596062
Zambia,2007,852759794,125591382,727168412,0.852723612342352
Zambia,2008,958413241,124282284,834130957,0.8703249509884432
Zambia,2009,1012824754,124332119,888492635,0.8772422193385688
Zambia,2010,1033376004,156887197,876488807,0.848179949609126
Zambia,2011,1201802998,165269038,1036533960,0.8624824215990182
Zambia,2012,1334630976,164458231,1170172745,0.87677625204467
Zambia,2013,1499077951,199683587,1299394364,0.8667957280895261
Zambia,2014,1575530447,232303421,1343227026,0.852555422561123
Zambia,2015,1339701086,233417384,1106283702,0.8257690566655255
Zambia,2016,1130043356,263517996,866525360,0.7668071808034239
Zambia,2017,1290943270,264234007,1026709263,0.7953171040583371
Zambia,2018,1481657471,261068189,1220589282,0.8237999037498188
Zambia,2019,1377404449,258015813,1119388636,0.8126797011674238
Zambia,2020,1421536592,255148538,1166388054,0.8205121560458571
Zimbabwe,1995,285803254,53156047,232647207,0.8140117501951185
Zimbabwe,1996,268237065,60537021,207700044,0.7743152274649292
Zimbabwe,1997,246139603,59818826,186320777,0.7569719570889208
Zimbabwe,1998,225928156,60109846,165818310,0.7339426521057428
Zimbabwe,1999,332764189,59401620,273362569,0.8214903467271835
Zimbabwe,2000,329638173,72505432,257132741,0.780045401477213
Zimbabwe,2001,304196334,71630042,232566292,0.7645269387105763
Zimbabwe,2002,400310177,70769241,329540936,0.8232139848895224
Zimbabwe,2003,654064589,69922787,584141802,0.893094981480491
Zimbabwe,2004,730715546,69090441,661625105,0.9054482399092136
Zimbabwe,2005,677308934,68271967,609036967,0.8992011420891726
Zimbabwe,2006,777931393,67467135,710464258,0.9132736696229458
Zimbabwe,2007,890758990,78084147,812674843,0.9123397598266171
Zimbabwe,2008,1093114158,91096178,1002017980,0.9166636189520473
Zimbabwe,2009,1011379594,89983389,921396205,0.9110290641280231
Zimbabwe,2010,1056014910,90226552,965788358,0.9145593957570164
Zimbabwe,2011,1016074421,89132077,926942344,0.9122780033058228
Zimbabwe,2012,1003324648,88055844,915268804,0.9122359406045409
Zimbabwe,2013,963864156,87862489,876001667,0.9088434937090866
Zimbabwe,2014,1047184168,86809886,960374282,0.9171016057607165
Zimbabwe,2015,810465040,88470370,721994670,0.8908399923086133
Zimbabwe,2016,431166430,87415338,343751092,0.797258478587955
Zimbabwe,2017,622743887,87134681,535609206,0.8600794278049654
Zimbabwe,2018,863760575,172123995,691636580,0.8007271922546361
Zimbabwe,2019,750493799,176204925,574288874,0.7652146823401001
Zimbabwe,2020,601885907,173953533,427932374,0.710985867957862
